awì̠ëka̠	 a w ì ̠ ë k a ̠ |
tkë́töm	 t k ë ́ t ö m |
tsa'kicha	 t s a ' k i c h a |
i'	 i ' |
wa	 w a |
be'	 b e ' |
ye'	 y e ' |
a̠	 a ̠ |
i	 i |
kalö̂u̠	 k a l ö ̂ u ̠ |
batà	 b a t à |
kú̠k	 k ú ̠ k |
tkë̀tökicha	 t k ë ̀ t ö k i c h a |
ë̀	 ë ̀ |
sibö̀	 s i b ö ̀ |
dör	 d ö r |
su̠lì̠	 s u ̠ l ì ̠ |
akë́köl	 a k ë ́ k ö l |
ché	 c h é |
kàl	 k à l |
mí̠shka	 m í ̠ s h k a |
dèstsa̠	 d è s t s a ̠ |
í̠ski̠	 í ̠ s k i ̠ |
ta̠	 t a ̠ |
kùkur	 k ù k u r |
ie'pa	 i e ' p a |
e̠'	 e ̠ ' |
kéka	 k é k a |
tö́k	 t ö ́ k |
bité̠a̠ne̠	 b i t é ̠ a ̠ n e ̠ |
mí̠a̠	 m í ̠ a ̠ |
wéblök	 w é b l ö k |
yö	 y ö |
a'	 a ' |
ku̠è̠mi̠	 k u ̠ è ̠ m i ̠ |
ie'	 i e ' |
yulé	 y u l é |
ku̠é̠	 k u ̠ é ̠ |
ö̀pa	 ö ̀ p a |
o'	 o ' |
pa̠rulòne̠	 p a ̠ r u l ò n e ̠ |
sa'	 s a ' |
tso'	 t s o ' |
akë́këpa	 a k ë ́ k ë p a |
e'	 e ' |
pà̠ne̠wa	 p à ̠ n e ̠ w a |
démi̠	 d é m i ̠ |
pá̠rlorne̠	 p á ̠ r l o r n e ̠ |
òka̠ma̠	 ò k a ̠ m a ̠ |
ska	 s k a |
apéitök	 a p é i t ö k |
kë̀	 k ë ̀ |
të̀na̠ne̠	 t ë ̀ n a ̠ n e ̠ |
té	 t é |
icha	 i c h a |
dalóie	 d a l ó i e |
kalö̂we̠	 k a l ö ̂ w e ̠ |
mò̠sopa	 m ò ̠ s o p a |
débitu̠	 d é b i t u ̠ |
kéka̠	 k é k a ̠ |
bikö́kmi̠	 b i k ö ́ k m i ̠ |
sawèi̠a̠	 s a w è i ̠ a ̠ |
rö	 r ö |
péite	 p é i t e |
sa̠wé̠	 s a ̠ w é ̠ |
tö	 t ö |
wake'	 w a k e ' |
ulà	 u l à |
télor	 t é l o r |
êrë	 ê r ë |
kí̠	 k í ̠ |
talârke̠	 t a l â r k e ̠ |
châbitu̠	 c h â b i t u ̠ |
íyök	 í y ö k |
yö̀ne̠	 y ö ̀ n e ̠ |
di'	 d i ' |
tsítsiie	 t s í t s i i e |
kiè	 k i è |
sìkua	 s ì k u a |
ujté	 u j t é |
ie	 i e |
laguna	 l a g u n a |
kiéne̠	 k i é n e ̠ |
wè̠s	 w è ̠ s |
ì	 ì |
ò̠ne̠i̠a̠	 ò ̠ n e ̠ i ̠ a ̠ |
ie'rö	 i e ' r ö |
biyö̀ché	 b i y ö ̀ c h é |
tsiö̀	 t s i ö ̀ |
ká̠köljtö	 k á ̠ k ö l j t ö |
tsakèke̠watke	 t s a k è k e ̠ w a t k e |
irir	 i r i r |
é̠ne̠	 é ̠ n e ̠ |
talárke̠	 t a l á r k e ̠ |
bë́rëbërë	 b ë ́ r ë b ë r ë |
bétk	 b é t k |
talâr	 t a l â r |
dómi̠	 d ó m i ̠ |
ë̀me̠	 ë ̀ m e ̠ |
e's	 e ' s |
déstsa̠	 d é s t s a ̠ |
mì̠k	 m ì ̠ k |
ú̠ne̠	 ú ̠ n e ̠ |
ku̠é̠ki̠	 k u ̠ é ̠ k i ̠ |
se'	 s e ' |
nú̠	 n ú ̠ |
tsakìne̠wa̠	 t s a k ì n e ̠ w a ̠ |
dawéwa	 d a w é w a |
balí	 b a l í |
wa̠	 w a ̠ |
ikuö̀wö	 i k u ö ̀ w ö |
të'r	 t ë ' r |
e't	 e ' t |
e'töm	 e ' t ö m |
ki̠	 k i ̠ |
tkë́rka̠	 t k ë ́ r k a ̠ |
batàie	 b a t à i e |
ie'pala	 i e ' p a l a |
a̠mé̠	 a ̠ m é ̠ |
katè	 k a t è |
dawé	 d a w é |
mí̠a̠ne̠	 m í ̠ a ̠ n e ̠ |
ajkö́nu̠kne̠	 a j k ö ́ n u ̠ k n e ̠ |
bukë'	 b u k ë ' |
ajkö́nè̠ke̠	 a j k ö ́ n è ̠ k e ̠ |
a̠ñì̠	 a ̠ ñ ì ̠ |
kí̠mù̠ke̠	 k í ̠ m ù ̠ k e ̠ |
bö̀t	 b ö ̀ t |
ajkö́nu̠k	 a j k ö ́ n u ̠ k |
mé̠tëshkö	 m é ̠ t ë s h k ö |
dur	 d u r |
nú̠ie	 n ú ̠ i e |
dìwö	 d ì w ö |
dé	 d é |
ma̠ñà̠t	 m a ̠ ñ à ̠ t |
dawówa̠	 d a w ó w a ̠ |
mé̠tër	 m é ̠ t ë r |
e̠'rök	 e ̠ ' r ö k |
tsèwa̠	 t s è w a ̠ |
sé̠	 s é ̠ |
mú̠tër	 m ú ̠ t ë r |
dawö̀râwa	 d a w ö ̀ r â w a |
ike	 i k e |
tsè	 t s è |
bö	 b ö |
i̠ù̠té	 i ̠ ù ̠ t é |
kuéwa̠	 k u é w a ̠ |
tkabë̀	 t k a b ë ̀ |
déne̠	 d é n e ̠ |
dawö'	 d a w ö ' |
chö́k	 c h ö ́ k |
à	 à |
kúkur	 k ú k u r |
chô	 c h ô |
yulö́k	 y u l ö ́ k |
kù̠ne̠	 k ù ̠ n e ̠ |
baté̠a̠ne̠	 b a t é ̠ a ̠ n e ̠ |
ku̠	 k u ̠ |
i̠a̠	 i ̠ a ̠ |
tkë́r	 t k ë ́ r |
ûriki̠	 û r i k i ̠ |
tsé	 t s é |
bulàne̠	 b u l à n e ̠ |
tkése̠	 t k é s e ̠ |
tkéwa̠	 t k é w a ̠ |
â̠mi̠k	 â ̠ m i ̠ k |
ujtö̀	 u j t ö ̀ |
tsë̀ne̠	 t s ë ̀ n e ̠ |
mô̠	 m ô ̠ |
mú̠ka̠	 m ú ̠ k a ̠ |
ôbata	 ô b a t a |
apéitemi̠	 a p é i t e m i ̠ |
chéne̠	 c h é n e ̠ |
ma̠ñà̠tökicha	 m a ̠ ñ à ̠ t ö k i c h a |
apéitö	 a p é i t ö |
aû	 a û |
apéitepa	 a p é i t e p a |
skà	 s k à |
ña̠	 ñ a ̠ |
ulàkata	 u l à k a t a |
shkó	 s h k ó |
shka'ku̠	 s h k a ' k u ̠ |
âr	 â r |
ë̂k	 ë ̂ k |
datsi'	 d a t s i ' |
yë́	 y ë ́ |
iéka̠	 i é k a ̠ |
kipö̀	 k i p ö ̀ |
e'ta̠	 e ' t a ̠ |
dalö̀ie	 d a l ö ̀ i e |
apéite	 a p é i t e |
apéitö́	 a p é i t ö ́ |
iö́k	 i ö ́ k |
ta̠î̠	 t a ̠ î ̠ |
í̠e̠	 í ̠ e ̠ |
kà̠li̠	 k à ̠ l i ̠ |
nû̠wè̠ke̠	 n û ̠ w è ̠ k e ̠ |
chìrwak	 c h ì r w a k |
kuèke̠	 k u è k e ̠ |
a̠wí̠	 a ̠ w í ̠ |
shkébitu̠	 s h k é b i t u ̠ |
stsâwak	 s t s â w a k |
mé̠r	 m é ̠ r |
déwa	 d é w a |
ù	 ù |
apàkök	 a p à k ö k |
bité̠	 b i t é ̠ |
ká̠	 k á ̠ |
i̠â̠i̠â̠	 i ̠ â ̠ i ̠ â ̠ |
bák	 b á k |
wé̠	 w é ̠ |
dá	 d á |
sa̠	 s a ̠ |
aláköl	 a l á k ö l |
wë́m	 w ë ́ m |
ujchè̠r	 u j c h è ̠ r |
apàkö	 a p à k ö |
kiàna̠	 k i à n a ̠ |
dayë̀	 d a y ë ̀ |
apàke	 a p à k e |
bua'	 b u a ' |
bua'ë	 b u a ' ë |
dawás	 d a w á s |
dö̀ke̠tke	 d ö ̀ k e ̠ t k e |
e'k	 e ' k |
e'ka	 e ' k a |
déka̠tke	 d é k a ̠ t k e |
ajá	 a j á |
sé̠rke̠	 s é ̠ r k e ̠ |
san	 s a n |
josé	 j o s é |
seminario	 s e m i n a r i o |
vicente	 v i c e n t e |
de	 d e |
paúl	 p a ú l |
í̠ma̠	 í ̠ m a ̠ |
î̠ñe̠	 î ̠ ñ e ̠ |
tso'ne̠	 t s o ' n e ̠ |
kibí	 k i b í |
mâ̠u̠k	 m â ̠ u ̠ k |
yë̀ne̠ttsa̠	 y ë ̀ n e ̠ t t s a ̠ |
tso'i̠a̠	 t s o ' i ̠ a ̠ |
wö́ulâu̠k	 w ö ́ u l â u ̠ k |
ö	 ö |
à̠	 à ̠ |
escuela	 e s c u e l a |
coroma	 c o r o m a |
colegio	 c o l e g i o |
aì	 a ì |
dieciocho	 d i e c i o c h o |
años	 a ñ o s |
andrey	 a n d r e y |
almengor	 a l m e n g o r |
ièke̠ka̠	 i è k e ̠ k a ̠ |
sö	 s ö |
dikì̠	 d i k ì ̠ |
ês	 ê s |
kirírke̠	 k i r í r k e ̠ |
di'ba	 d i ' b a |
ièke̠	 i è k e ̠ |
kö̀	 k ö ̀ |
tèke̠	 t è k e ̠ |
sí	 s í |
kapö́li	 k a p ö ́ l i |
ichapa	 i c h a p a |
kò̠s	 k ò ̠ s |
pues	 p u e s |
mì̠ni̠a̠	 m ì ̠ n i ̠ a ̠ |
wák	 w á k |
itö̀ki̠	 i t ö ̀ k i ̠ |
tsèke̠i̠a̠	 t s è k e ̠ i ̠ a ̠ |
mi̠'ke̠	 m i ̠ ' k e ̠ |
wé̠alè	 w é ̠ a l è |
si̠é̠	 s i ̠ é ̠ |
à̠a̠	 à ̠ a ̠ |
ya	 y a |
yèi̠a̠	 y è i ̠ a ̠ |
ujú	 u j ú |
yè	 y è |
ye'r	 y e ' r |
ñe̠'	 ñ e ̠ ' |
itö̀ièmi̠	 i t ö ̀ i è m i ̠ |
sé̠n	 s é ̠ n |
ñê̠es	 ñ ê ̠ e s |
wámblë'	 w á m b l ë ' |
ujú̠	 u j ú ̠ |
sè̠ne̠	 s è ̠ n e ̠ |
pero	 p e r o |
alà	 a l à |
tsítsi	 t s í t s i |
tsö́r	 t s ö ́ r |
dâ	 d â |
mí̠	 m í ̠ |
tsène̠	 t s è n e ̠ |
wé	 w é |
ne̠	 n e ̠ |
otra	 o t r a |
vez	 v e z |
bua'ne̠	 b u a ' n e ̠ |
kë́këpa	 k ë ́ k ë p a |
ka̠nè̠wè̠ke̠	 k a ̠ n è ̠ w è ̠ k e ̠ |
bua'ie	 b u a ' i e |
ala'rla	 a l a ' r l a |
tsö̀ne̠	 t s ö ̀ n e ̠ |
talàne̠	 t a l à n e ̠ |
rö̀	 r ö ̀ |
ma̠	 m a ̠ |
hospital	 h o s p i t a l |
sú̠rule	 s ú ̠ r u l e |
kë̀chkepa	 k ë ̀ c h k e p a |
taláo̠'	 t a l á o ̠ ' |
mì̠kalè	 m ì ̠ k a l è |
chówa	 c h ó w a |
ajkuö̀	 a j k u ö ̀ |
tkèke̠	 t k è k e ̠ |
ñá̠	 ñ á ̠ |
yèke̠	 y è k e ̠ |
mu̠lù̠tak	 m u ̠ l ù ̠ t a k |
o̠'	 o ̠ ' |
dalë́r	 d a l ë ́ r |
usa	 u s a |
wèi̠a̠	 w è i ̠ a ̠ |
yì	 y ì |
alèke̠	 a l è k e ̠ |
mè̠	 m è ̠ |
dóli	 d ó l i |
chkà	 c h k à |
sú̠	 s ú ̠ |
na̠mù̠	 n a ̠ m ù ̠ |
yíkbla	 y í k b l a |
diö́	 d i ö ́ |
wö̂rkuala	 w ö ̂ r k u a l a |
dià	 d i à |
si̠wa̠'wö	 s i ̠ w a ̠ ' w ö |
tkë̀rke̠wa̠	 t k ë ̀ r k e ̠ w a ̠ |
por	 p o r |
que	 q u e |
tkìne̠	 t k ì n e ̠ |
wà	 w à |
ka̠nè̠wè̠i̠a̠	 k a ̠ n è ̠ w è ̠ i ̠ a ̠ |
kirë̀rma̠	 k i r ë ̀ r m a ̠ |
yulémi̠tke	 y u l é m i ̠ t k e |
chë́r	 c h ë ́ r |
é	 é |
ka̠né̠wè̠ke̠	 k a ̠ n é ̠ w è ̠ k e ̠ |
kiàne̠	 k i à n e ̠ |
ti̠è̠ka̠	 t i ̠ è ̠ k a ̠ |
wö́kir	 w ö ́ k i r |
tsé̠bite̠	 t s é ̠ b i t e ̠ |
wé̠shke̠	 w é ̠ s h k e ̠ |
ali'	 a l i ' |
iö́köl	 i ö ́ k ö l |
yawè	 y a w è |
kalö́m	 k a l ö ́ m |
sku'	 s k u ' |
tsé̠mi̠	 t s é ̠ m i ̠ |
wàtu̠e̠	 w à t u ̠ e ̠ |
yawèke̠	 y a w è k e ̠ |
i̠	 i ̠ |
à̠te̠	 à ̠ t e ̠ |
yö̀na̠tke	 y ö ̀ n a ̠ t k e |
wàtu̠è̠ke̠	 w à t u ̠ è ̠ k e ̠ |
buáala	 b u á a l a |
tàna̠	 t à n a ̠ |
kàlkö	 k à l k ö |
ñé̠	 ñ é ̠ |
aléka̠	 a l é k a ̠ |
dìba	 d ì b a |
ié	 i é |
tâwe̠	 t â w e ̠ |
yawé	 y a w é |
bité̠tke	 b i t é ̠ t k e |
ñé̠e̠	 ñ é ̠ e ̠ |
tâu̠köl	 t â u ̠ k ö l |
ë	 ë |
ka̠nè̠we̠	 k a ̠ n è ̠ w e ̠ |
e'ta	 e ' t a |
mí̠tke	 m í ̠ t k e |
wàta̠ú̠k	 w à t a ̠ ú ̠ k |
buélormi̠	 b u é l o r m i ̠ |
sku'la	 s k u ' l a |
chaléla	 c h a l é l a |
mé̠	 m é ̠ |
síu̠k	 s í u ̠ k |
pàsina̠	 p à s i n a ̠ |
ké̠we̠	 k é ̠ w e ̠ |
tulére	 t u l é r e |
tôna̠	 t ô n a ̠ |
éjkë	 é j k ë |
pàsi̠é̠lor	 p à s i ̠ é ̠ l o r |
kë'köldi	 k ë ' k ö l d i |
tsë́r	 t s ë ́ r |
ajkà	 a j k à |
mé̠ka̠	 m é ̠ k a ̠ |
wö́kirpa	 w ö ́ k i r p a |
sarûrû	 s a r û r û |
mì̠ka̠	 m ì ̠ k a ̠ |
a̠mé̠ne̠	 a ̠ m é ̠ n e ̠ |
kirìna̠	 k i r ì n a ̠ |
bua'wè̠ke̠	 b u a ' w è ̠ k e ̠ |
a̠me̠'a̠t	 a ̠ m e ̠ ' a ̠ t |
à̠s	 à ̠ s |
awápa	 a w á p a |
ka̠nè̠u̠	 k a ̠ n è ̠ u ̠ |
tsë'ka̠	 t s ë ' k a ̠ |
jkö̀	 j k ö ̀ |
mi̠k	 m i ̠ k |
kë'köl	 k ë ' k ö l |
kéli	 k é l i |
bua'wó̠	 b u a ' w ó ̠ |
chè	 c h è |
ka̠nè̠	 k a ̠ n è ̠ |
yàmi̠pa	 y à m i ̠ p a |
ka̠nè̠blök	 k a ̠ n è ̠ b l ö k |
dapáu̠k	 d a p á u ̠ k |
buà	 b u à |
ka̠nè̠u̠k	 k a ̠ n è ̠ u ̠ k |
alö̂u̠k	 a l ö ̂ u ̠ k |
tsiru'	 t s i r u ' |
alo'yök	 a l o ' y ö k |
ukö̀ki̠	 u k ö ̀ k i ̠ |
bùsi	 b ù s i |
a̠mì̠	 a ̠ m ì ̠ |
kí̠me̠	 k í ̠ m e ̠ |
dakaròla	 d a k a r ò l a |
tiö́k	 t i ö ́ k |
tsú̠k	 t s ú ̠ k |
ùshña̠	 ù s h ñ a ̠ |
tkö́ktsa̠	 t k ö ́ k t s a ̠ |
juanita	 j u a n i t a |
si̠à̠rla	 s i ̠ à ̠ r l a |
i̠nú̠köl	 i ̠ n ú ̠ k ö l |
ta̠'	 t a ̠ ' |
chkö̀	 c h k ö ̀ |
ujtèku̠	 u j t è k u ̠ |
ikuö̀	 i k u ö ̀ |
ujtèku	 u j t è k u |
blë'kë́këpa	 b l ë ' k ë ́ k ë p a |
i̠â̠chki	 i ̠ â ̠ c h k i |
si̠à̠r	 s i ̠ à ̠ r |
dùla	 d ù l a |
ta̠'i̠a̠	 t a ̠ ' i ̠ a ̠ |
è̠na̠wa̠tke	 è ̠ n a ̠ w a ̠ t k e |
diö̀	 d i ö ̀ |
a̠ñì̠es	 a ̠ ñ ì ̠ e s |
ta̠î̠ë	 t a ̠ î ̠ ë |
ké̠ska	 k é ̠ s k a |
síwöla	 s í w ö l a |
katèke̠	 k a t è k e ̠ |
po'po'	 p o ' p o ' |
kalö́tak	 k a l ö ́ t a k |
ajkö̀	 a j k ö ̀ |
é̠n	 é ̠ n |
katâku̠	 k a t â k u ̠ |
e'skapë	 e ' s k a p ë |
blë'këkëpa	 b l ë ' k ë k ë p a |
síwè̠ke̠	 s í w è ̠ k e ̠ |
alákölpa	 a l á k ö l p a |
síwè̠ka̠	 s í w è ̠ k a ̠ |
déka̠	 d é k a ̠ |
mì̠kalê	 m ì ̠ k a l ê |
dabòp	 d a b ò p |
chké	 c h k é |
yétsa̠	 y é t s a ̠ |
sulë̀	 s u l ë ̀ |
bö̀töm	 b ö ̀ t ö m |
ma̠ñà̠töm	 m a ̠ ñ à ̠ t ö m |
pô	 p ô |
ni̠mà̠	 n i ̠ m à ̠ |
ujtè	 u j t è |
ujtèke̠	 u j t è k e ̠ |
e'la	 e ' l a |
kièke̠	 k i è k e ̠ |
ichö́li	 i c h ö ́ l i |
tsukúi	 t s u k ú i |
blài	 b l à i |
pôë	 p ô ë |
ni̠mà̠ichö́k	 n i ̠ m à ̠ i c h ö ́ k |
sulë̀wöla	 s u l ë ̀ w ö l a |
kù̠na̠	 k ù ̠ n a ̠ |
mó̠köl	 m ó ̠ k ö l |
ujtó	 u j t ó |
katàne̠	 k a t à n e ̠ |
ulàtta̠	 u l à t t a ̠ |
kö́t	 k ö ́ t |
wö́blar	 w ö ́ b l a r |
kua'böt	 k u a ' b ö t |
ése	 é s e |
sulë̀wö	 s u l ë ̀ w ö |
alí	 a l í |
dárke̠	 d á r k e ̠ |
si̠ni̠'	 s i ̠ n i ̠ ' |
déwa̠	 d é w a ̠ |
té̠rke̠	 t é ̠ r k e ̠ |
kàlwö	 k à l w ö |
àl	 à l |
tulúrse̠	 t u l ú r s e ̠ |
sàl	 s à l |
wìm	 w ì m |
bak	 b a k |
pà	 p à |
bë̂rie	 b ë ̂ r i e |
be'r	 b e ' r |
dawö́	 d a w ö ́ |
darë̂rë̂	 d a r ë ̂ r ë ̂ |
ská̠mo̠köl	 s k á ̠ m o ̠ k ö l |
dù	 d ù |
tulúrka̠	 t u l ú r k a ̠ |
si̠ê̠ë	 s i ̠ ê ̠ ë |
alárke̠ka̠	 a l á r k e ̠ k a ̠ |
òëòë	 ò ë ò ë |
ká̠rki̠	 k á ̠ r k i ̠ |
mâ̠tk	 m â ̠ t k |
íyiwak	 í y i w a k |
wös	 w ö s |
alá	 a l á |
kabë̀lala	 k a b ë ̀ l a l a |
tèröl	 t è r ö l |
kúl	 k ú l |
mà̠so	 m à ̠ s o |
wé̠shke̠ne̠	 w é ̠ s h k e ̠ n e ̠ |
wàta̠wè̠	 w à t a ̠ w è ̠ |
kalö̀	 k a l ö ̀ |
wàtó̠rke̠	 w à t ó ̠ r k e ̠ |
cha̠mù̠	 c h a ̠ m ù ̠ |
ñè̠ke̠	 ñ è ̠ k e ̠ |
alâr	 a l â r |
íyi	 í y i |
yìr	 y ì r |
ta̠wè̠ku̠	 t a ̠ w è ̠ k u ̠ |
ta̠wè̠	 t a ̠ w è ̠ |
átu	 á t u |
kuátkök	 k u á t k ö k |
ñè̠	 ñ è ̠ |
àrros	 à r r o s |
bikö́k	 b i k ö ́ k |
tabè	 t a b è |
ka̠nè̠blèmi̠	 k a ̠ n è ̠ b l è m i ̠ |
duládula	 d u l á d u l a |
setenta	 s e t e n t a |
kùlyök	 k ù l y ö k |
rigoberto	 r i g o b e r t o |
morales	 m o r a l e s |
tskìne̠	 t s k ì n e ̠ |
kö̀wö	 k ö ̀ w ö |
tètsa̠	 t è t s a ̠ |
alè	 a l è |
bâwe̠	 b â w e ̠ |
shù̠	 s h ù ̠ |
tèmi̠	 t è m i ̠ |
pë́	 p ë ́ |
ujtèke̠wa̠	 u j t è k e ̠ w a ̠ |
dawè	 d a w è |
kalö̂wè̠ke̠ne̠	 k a l ö ̂ w è ̠ k e ̠ n e ̠ |
kalö̂wè̠ke̠	 k a l ö ̂ w è ̠ k e ̠ |
si	 s i |
katèwa	 k a t è w a |
wáñe̠	 w á ñ e ̠ |
katé	 k a t é |
ala'r	 a l a ' r |
tsi̠nì̠kichawak	 t s i ̠ n ì ̠ k i c h a w a k |
bë̂rë	 b ë ̂ r ë |
katármi̠	 k a t á r m i ̠ |
së́bliwak	 s ë ́ b l i w a k |
u̠jú̠	 u ̠ j ú ̠ |
tö́	 t ö ́ |
ká̠	 k á ̠ |
tèröl	 t è r ö l |
se'	 s e ' |
e's	 e ' s |
tër	 t ë r |
idirla	 i d i r l a |
e'	 e ' |
dör	 d ö r |
ie'	 i e ' |
dawè	 d a w è |
tè	 t è |
pú	 p ú |
irir	 i r i r |
kàl	 k à l |
wö	 w ö |
iene̠	 i e n e ̠ |
ie	 i e |
i	 i |
wà	 w à |
bë̂r	 b ë ̂ r |
yë̂ar	 y ë ̂ a r |
e'tk	 e ' t k |
ë̀	 ë ̀ |
ú̠jù̠	 ú ̠ j ù ̠ |
tsiö̀	 t s i ö ̀ |
ù	 ù |
batà	 b a t à |
uju	 u j u |
e'kët	 e ' k ë t |
ta̠	 t a ̠ |
bua'	 b u a ' |
wö̀na̠	 w ö ̀ n a ̠ |
dayë̀	 d a y ë ̀ |
yö̀ne̠	 y ö ̀ n e ̠ |
sibö̀	 s i b ö ̀ |
a̠	 a ̠ |
ché	 c h é |
be'	 b e ' |
e̠'	 e ̠ ' |
shkö́bitu̠	 s h k ö ́ b i t u ̠ |
a̠wí̠	 a ̠ w í ̠ |
kò̠s	 k ò ̠ s |
ki̠	 k i ̠ |
dawás	 d a w á s |
tso'	 t s o ' |
sìkuapa	 s ì k u a p a |
icha	 i c h a |
itö̀ièke̠	 i t ö ̀ i è k e ̠ |
no	 n o |
ì	 ì |
se'la	 s e ' l a |
yö́	 y ö ́ |
söla	 s ö l a |
sö	 s ö |
balo'rila	 b a l o ' r i l a |
buáala	 b u á a l a |
balo'ri	 b a l o ' r i |
sharila	 s h a r i l a |
a̠là̠chkala	 a ̠ l à ̠ c h k a l a |
ta̠la	 t a ̠ l a |
ye'	 y e ' |
dawèka̠la	 d a w è k a ̠ l a |
aláköla	 a l á k ö l a |
sû̠	 s û ̠ |
sula'	 s u l a ' |
ichàkökala	 i c h à k ö k a l a |
kirë̀rma̠	 k i r ë ̀ r m a ̠ |
kirë̀rma̠la	 k i r ë ̀ r m a ̠ l a |
wö̀	 w ö ̀ |
a̠la	 a ̠ l a |
kë̀la	 k ë ̀ l a |
aë̀rwala	 a ë ̀ r w a l a |
töla	 t ö l a |
ìla	 ì l a |
aë̀	 a ë ̀ |
ijtsèmi̠la	 i j t s è m i ̠ l a |
à	 à |
kë́këpa	 k ë ́ k ë p a |
i̠'ñe̠	 i ̠ ' ñ e ̠ |
sa'	 s a ' |
tö	 t ö |
mí̠a̠	 m í ̠ a ̠ |
wë'stela	 w ë ' s t e l a |
ta̠î̠ë	 t a ̠ î ̠ ë |
ujté	 u j t é |
ta̠î̠	 t a ̠ î ̠ |
kabéne̠	 k a b é n e ̠ |
we'ine̠	 w e ' i n e ̠ |
si̠à̠rë	 s i ̠ à ̠ r ë |
yàmi̠pa	 y à m i ̠ p a |
we'ike	 w e ' i k e |
wa̠	 w a ̠ |
bua'ë	 b u a ' ë |
kí̠mè̠ke̠	 k í ̠ m è ̠ k e ̠ |
ku̠é̠ki̠	 k u ̠ é ̠ k i ̠ |
é̠n	 é ̠ n |
chak	 c h a k |
kiè	 k i è |
alà	 a l à |
kie	 k i e |
jesús	 j e s ú s |
amén	 a m é n |
ké̠we	 k é ̠ w e |
tsiru'	 t s i r u ' |
tèke̠	 t è k e ̠ |
tsakèke̠	 t s a k è k e ̠ |
é	 é |
ma̠	 m a ̠ |
shkö́wè̠ke̠	 s h k ö ́ w è ̠ k e ̠ |
síkwa	 s í k w a |
të́rulewa̠	 t ë ́ r u l e w a ̠ |
ékëpa	 é k ë p a |
mè̠ke̠ttsa̠	 m è ̠ k e ̠ t t s a ̠ |
dìba	 d ì b a |
sìne̠	 s ì n e ̠ |
kukèke̠	 k u k è k e ̠ |
wö̀ppèke̠	 w ö ̀ p p è k e ̠ |
wèke̠	 w è k e ̠ |
tabèchka	 t a b è c h k a |
ki̠ka	 k i ̠ k a |
blôblô	 b l ô b l ô |
chkà	 c h k à |
páköl	 p á k ö l |
mi̠	 m i ̠ |
mè̠ke̠ka̠	 m è ̠ k e ̠ k a ̠ |
bö'	 b ö ' |
daléwa	 d a l é w a |
mo̠ló̠tsmo̠ló̠ts	 m o ̠ l ó ̠ t s m o ̠ l ó ̠ t s |
íyi	 í y i |
ièka̠	 i è k a ̠ |
i̠a̠	 i ̠ a ̠ |
sìkua	 s ì k u a |
canela	 c a n e l a |
e̠ma̠	 e ̠ m a ̠ |
dlásháwö	 d l á s h á w ö |
shá̠mé̠la	 s h á ̠ m é ̠ l a |
apà	 a p à |
butrèke̠wa̠	 b u t r è k e ̠ w a ̠ |
yë́jkuö	 y ë ́ j k u ö |
wa	 w a |
ta̠wè̠ke̠	 t a ̠ w è ̠ k e ̠ |
bulu'pa	 b u l u ' p a |
bueno	 b u e n o |
í̠e̠	 í ̠ e ̠ |
rè	 r è |
e'ta̠	 e ' t a ̠ |
yulár	 y u l á r |
wö̀ke̠	 w ö ̀ k e ̠ |
wè̠s	 w è ̠ s |
a'r	 a ' r |
sa̠wè̠	 s a ̠ w è ̠ |
bribripa	 b r i b r i p a |
ák	 á k |
mè̠a̠t	 m è ̠ a ̠ t |
wö́köl	 w ö ́ k ö l |
kë̀	 k ë ̀ |
ô̠ka	 ô ̠ k a |
mè̠ne̠a̠t	 m è ̠ n e ̠ a ̠ t |
wö́k	 w ö ́ k |
a̠wì̠	 a ̠ w ì ̠ |
pàke	 p à k e |
rë'ka̠	 r ë ' k a ̠ |
dià	 d i à |
kièke̠	 k i è k e ̠ |
ká̠ska	 k á ̠ s k a |
ma̠nè̠te̠	 m a ̠ n è ̠ t e ̠ |
ditsö̀wö	 d i t s ö ̀ w ö |
ikuö̀wö	 i k u ö ̀ w ö |
ése	 é s e |
ditséwö	 d i t s é w ö |
mì̠ka̠	 m ì ̠ k a ̠ |
tskìne̠	 t s k ì n e ̠ |
sulàyöm	 s u l à y ö m |
me̠'a̠t	 m e ̠ ' a ̠ t |
ñá̠no̠	 ñ á ̠ n o ̠ |
katáno̠	 k a t á n o ̠ |
chkö́köl	 c h k ö ́ k ö l |
sè̠nu̠köl	 s è ̠ n u ̠ k ö l |
î̠ñe̠	 î ̠ ñ e ̠ |
katèke̠	 k a t è k e ̠ |
mì̠k	 m ì ̠ k |
nê̠ne̠	 n ê ̠ n e ̠ |
hasta	 h a s t a |
rö	 r ö |
sì̠na̠	 s ì ̠ n a ̠ |
éjkë	 é j k ë |
i̠à̠na̠	 i ̠ à ̠ n a ̠ |
tso'se̠n	 t s o ' s e ̠ n |
ùrke̠	 ù r k e ̠ |
ujtö̀ie	 u j t ö ̀ i e |
sé̠rke̠	 s é ̠ r k e ̠ |
bùsila	 b ù s i l a |
wö́ulâù̠ke̠	 w ö ́ u l â ù ̠ k e ̠ |
ö	 ö |
bùsi	 b ù s i |
ulà	 u l à |
batsèmi̠	 b a t s è m i ̠ |
mà̠so	 m à ̠ s o |
kú̠rmi̠	 k ú ̠ r m i ̠ |
wö́ulâna̠tketke	 w ö ́ u l â n a ̠ t k e t k e |
éki	 é k i |
sé̠	 s é ̠ |
tsè̠ke̠	 t s è ̠ k e ̠ |
éyökie	 é y ö k i e |
dö̀ka̠	 d ö ̀ k a ̠ |
ékölëme̠	 é k ö l ë m e ̠ |
rö̀	 r ö ̀ |
ké̠	 k é ̠ |
blo'	 b l o ' |
yèke̠	 y è k e ̠ |
chkö̀ke̠rak	 c h k ö ̀ k e ̠ r a k |
tso'rak	 t s o ' r a k |
ñî̠	 ñ î ̠ |
ñì̠	 ñ ì ̠ |
kímu̠kdak	 k í m u ̠ k d a k |
wé̠se	 w é ̠ s e |
yìr	 y ì r |
ièke̠	 i è k e ̠ |
ñé̠	 ñ é ̠ |
wé̠shke̠	 w é ̠ s h k e ̠ |
mì̠kle	 m ì ̠ k l e |
a̠wí̠es	 a ̠ w í ̠ e s |
e'rör	 e ' r ö r |
wé̠	 w é ̠ |
e'köl	 e ' k ö l |
yì	 y ì |
bua'r	 b u a ' r |
kià̠na̠	 k i à ̠ n a ̠ |
e̠'rö	 e ̠ ' r ö |
wákpa	 w á k p a |
sé̠ndak	 s é ̠ n d a k |
ujtö̀	 u j t ö ̀ |
sé̠n	 s é ̠ n |
tsikìne̠	 t s i k ì n e ̠ |
amù̠bli	 a m ù ̠ b l i |
talàne̠	 t a l à n e ̠ |
mama	 m a m a |
bö̀k	 b ö ̀ k |
ma̠nè̠ta̠	 m a ̠ n è ̠ t a ̠ |
ñe̠'	 ñ e ̠ ' |
klö̀	 k l ö ̀ |
este	 e s t e |
boca	 b o c a |
urén	 u r é n |
ká̠batà	 k á ̠ b a t à |
ma̠nè̠t	 m a ̠ n è ̠ t |
kibí	 k i b í |
que	 q u e |
ya	 y a |
yö	 y ö |
esposo	 e s p o s o |
ta̠'	 t a ̠ ' |
dë'rö	 d ë ' r ö |
tsú̠k	 t s ú ̠ k |
entonces	 e n t o n c e s |
dìwö	 d ì w ö |
dé	 d é |
kúkur	 k ú k u r |
pàköl	 p à k ö l |
i'	 i ' |
pero	 p e r o |
dë'	 d ë ' |
dë'tsa̠	 d ë ' t s a ̠ |
sè̠ne̠	 s è ̠ n e ̠ |
yàk	 y à k |
sa̠	 s a ̠ |
casi	 c a s i |
e'k	 e ' k |
ukö̀ki̠	 u k ö ̀ k i ̠ |
yö'	 y ö ' |
ahora	 a h o r a |
sí	 s í |
tkë̀r	 t k ë ̀ r |
ká̠m	 k á ̠ m |
chö̀wa	 c h ö ̀ w a |
yë́	 y ë ́ |
si̠wa̠'	 s i ̠ w a ̠ ' |
të'r	 t ë ' r |
ala'rala	 a l a ' r a l a |
tskìna̠	 t s k ì n a ̠ |
kù̠na̠	 k ù ̠ n a ̠ |
ie'pa	 i e ' p a |
hospital	 h o s p i t a l |
talàna̠	 t a l à n a ̠ |
wö́ulâa̠'	 w ö ́ u l â a ̠ ' |
sa̠ú̠k	 s a ̠ ú ̠ k |
pôó̠rulur	 p ô ó ̠ r u l u r |
kibìna̠	 k i b ì n a ̠ |
mí̠tke	 m í ̠ t k e |
solo	 s o l o |
à̠te̠	 à ̠ t e ̠ |
e'köla	 e ' k ö l a |
porque	 p o r q u e |
dë'u̠ntu	 d ë ' u ̠ n t u |
e'tala	 e ' t a l a |
chóla	 c h ó l a |
chë'wa	 c h ë ' w a |
ajá	 a j á |
ujú	 u j ú |
como	 c o m o |
ajké̠	 a j k é ̠ |
propio	 p r o p i o |
ye'r	 y e ' r |
mí̠k	 m í ̠ k |
alí	 a l í |
cortadora	 c o r t a d o r a |
té	 t é |
kókó	 k ó k ó |
détsa̠	 d é t s a ̠ |
tal	 t a l |
vez	 v e z |
saco	 s a c o |
be'r	 b e ' r |
mé̠a̠t	 m é ̠ a ̠ t |
dö̀	 d ö ̀ |
su̠lì̠tu	 s u ̠ l ì ̠ t u |
mé̠r	 m é ̠ r |
síu̠k	 s í u ̠ k |
bétk	 b é t k |
sìna̠wa̠	 s ì n a ̠ w a ̠ |
sìna̠	 s ì n a ̠ |
tkë́l	 t k ë ́ l |
kukèke̠tke	 k u k è k e ̠ t k e |
ù̠	 ù ̠ |
bá	 b á |
sa̠ú̠	 s a ̠ ú ̠ |
kukö́k	 k u k ö ́ k |
katùna̠	 k a t ù n a ̠ |
wö̀ishchèke̠	 w ö ̀ i s h c h è k e ̠ |
ajkuö́lit	 a j k u ö ́ l i t |
yéulur	 y é u l u r |
máquina	 m á q u i n a |
sa'r	 s a ' r |
i̠â̠chkí	 i ̠ â ̠ c h k í |
kukö̀ke̠	 k u k ö ̀ k e ̠ |
a'	 a ' |
pàkeke̠	 p à k e k e ̠ |
tskírke̠	 t s k í r k e ̠ |
chè	 c h è |
mí̠ka̠	 m í ̠ k a ̠ |
e'rö	 e ' r ö |
ñá̠	 ñ á ̠ |
a̠mì̠	 a ̠ m ì ̠ |
kiàna̠	 k i à n a ̠ |
pàkuemle̠	 p à k u e m l e ̠ |
óköpa	 ó k ö p a |
rë́ka̠	 r ë ́ k a ̠ |
wíköl	 w í k ö l |
pàtkeke̠	 p à t k e k e ̠ |
mè̠bitu̠	 m è ̠ b i t u ̠ |
yawè	 y a w è |
di'	 d i ' |
rë́ka̠i̠a̠	 r ë ́ k a ̠ i ̠ a ̠ |
pà	 p à |
sùne̠	 s ù n e ̠ |
ka̠nè̠u̠k	 k a ̠ n è ̠ u ̠ k |
bitè̠	 b i t è ̠ |
pàtkebitu̠	 p à t k e b i t u ̠ |
chèa̠t	 c h è a ̠ t |
ké	 k é |
ka̠nè̠u̠	 k a ̠ n è ̠ u ̠ |
mí̠tkemu̠le̠	 m í ̠ t k e m u ̠ l e ̠ |
ujtè	 u j t è |
mí̠ke̠mu̠le̠	 m í ̠ k e ̠ m u ̠ l e ̠ |
satë̀	 s a t ë ̀ |
kìta̠	 k ì t a ̠ |
mé̠mu̠le̠	 m é ̠ m u ̠ l e ̠ |
sa̠wé̠	 s a ̠ w é ̠ |
mò̠ki̠	 m ò ̠ k i ̠ |
yë'	 y ë ' |
se'r	 s e ' r |
ka̠nè̠o̠'	 k a ̠ n è ̠ o ̠ ' |
kí̠	 k í ̠ |
bakò̠s	 b a k ò ̠ s |
a̠ñì̠es	 a ̠ ñ ì ̠ e s |
i̠ù̠te	 i ̠ ù ̠ t e |
chèrak	 c h è r a k |
idir	 i d i r |
katè	 k a t è |
ajkë́u̠k	 a j k ë ́ u ̠ k |
kàne̠	 k à n e ̠ |
a̠ñì̠	 a ̠ ñ ì ̠ |
yö̀ki̠	 y ö ̀ k i ̠ |
à̠s	 à ̠ s |
tsikìna̠	 t s i k ì n a ̠ |
réwa̠	 r é w a ̠ |
sè̠nu̠k	 s è ̠ n u ̠ k |
dalë́ri	 d a l ë ́ r i |
dalö̀iökdak	 d a l ö ̀ i ö k d a k |
yë'a̠t	 y ë ' a ̠ t |
tsikírke̠	 t s i k í r k e ̠ |
ñé̠e̠	 ñ é ̠ e ̠ |
tsá̠we	 t s á ̠ w e |
dë́bitu̠dak	 d ë ́ b i t u ̠ d a k |
bö́l	 b ö ́ l |
ma̠ñá̠l	 m a ̠ ñ á ̠ l |
ë̀me̠	 ë ̀ m e ̠ |
e'pa	 e ' p a |
wé	 w é |
wéla	 w é l a |
tkë́rka̠	 t k ë ́ r k a ̠ |
tkë́rka̠rak	 t k ë ́ r k a ̠ r a k |
alákölpa	 a l á k ö l p a |
bitu̠ke̠rak	 b i t u ̠ k e ̠ r a k |
ala'r	 a l a ' r |
tsikírke̠tke	 t s i k í r k e ̠ t k e |
awá	 a w á |
óköm	 ó k ö m |
kapèblök	 k a p è b l ö k |
bátsena̠mu̠le̠	 b á t s e n a ̠ m u ̠ l e ̠ |
ka̠nè̠wè̠ke̠	 k a ̠ n è ̠ w è ̠ k e ̠ |
wák	 w á k |
ka'	 k a ' |
bák	 b á k |
tsîr	 t s î r |
ká̠mî̠ë	 k á ̠ m î ̠ ë |
cabagra	 c a b a g r a |
ajkö̀	 a j k ö ̀ |
a̠wí̠she̠t	 a ̠ w í ̠ s h e ̠ t |
ë̀ka̠	 ë ̀ k a ̠ |
santa	 s a n t a |
elena	 e l e n a |
puente	 p u e n t e |
mí̠ke̠	 m í ̠ k e ̠ |
mú̠köl	 m ú ̠ k ö l |
talâo̠	 t a l â o ̠ |
mì̠	 m ì ̠ |
êköl	 ê k ö l |
wë̂i̠a̠	 w ë ̂ i ̠ a ̠ |
escuela	 e s c u e l a |
skà	 s k à |
ichàkeke̠	 i c h à k e k e ̠ |
wö́blar	 w ö ́ b l a r |
ni̠mà̠	 n i ̠ m à ̠ |
kalíu̠k	 k a l í u ̠ k |
mí̠kalè	 m í ̠ k a l è |
ka̠ñí̠k	 k a ̠ ñ í ̠ k |
bàn	 b à n |
ùyöm	 ù y ö m |
wé̠alè	 w é ̠ a l è |
dë́rule	 d ë ́ r u l e |
apàkö́	 a p à k ö ́ |
ña̠	 ñ a ̠ |
kalíwe̠	 k a l í w e ̠ |
ukö̀	 u k ö ̀ |
mí̠	 m í ̠ |
bö	 b ö |
wö̀iewa̠	 w ö ̀ i e w a ̠ |
á̠jà̠	 á ̠ j à ̠ |
pues	 p u e s |
té̠rke̠	 t é ̠ r k e ̠ |
ké̠kra	 k é ̠ k r a |
diö́	 d i ö ́ |
río	 r í o |
y	 y |
cordillera	 c o r d i l l e r a |
mi̠k	 m i ̠ k |
muchos	 m u c h o s |
digamos	 d i g a m o s |
i̠â̠i̠â̠	 i ̠ â ̠ i ̠ â ̠ |
jké̠	 j k é ̠ |
sàl	 s à l |
ö̀k	 ö ̀ k |
íyiwak	 í y i w a k |
êrë	 ê r ë |
chìchi	 c h ì c h i |
yë́s	 y ë ́ s |
ajkè̠n	 a j k è ̠ n |
ni̠mé̠i	 n i ̠ m é ̠ i |
mu̠lû̠wak	 m u ̠ l û ̠ w a k |
dakòlwak	 d a k ò l w a k |
wàtak	 w à t a k |
kàlni̠me̠	 k à l n i ̠ m e ̠ |
bulë̀rwak	 b u l ë ̀ r w a k |
ñí̠we	 ñ í ̠ w e |
na̠ñé̠we	 n a ̠ ñ é ̠ w e |
mì̠kalê	 m ì ̠ k a l ê |
ñê̠es	 ñ ê ̠ e s |
bìt	 b ì t |
ulàttöu̠k	 u l à t t ö u ̠ k |
aû	 a û |
bö̀tk	 b ö ̀ t k |
ma̠ñà̠tk	 m a ̠ ñ à ̠ t k |
tsé̠a̠t	 t s é ̠ a ̠ t |
kapë́rule	 k a p ë ́ r u l e |
kapö̀ke̠	 k a p ö ̀ k e ̠ |
sík	 s í k |
kö̀	 k ö ̀ |
yawèka̠	 y a w è k a ̠ |
dikì̠	 d i k ì ̠ |
chkö̀	 c h k ö ̀ |
mí̠rule	 m í ̠ r u l e |
àrros	 à r r o s |
así	 a s í |
kalö́m	 k a l ö ́ m |
mismo	 m i s m o |
sí̠	 s í ̠ |
dapö̀	 d a p ö ̀ |
ku̠é̠	 k u ̠ é ̠ |
bìl	 b ì l |
yàmi̠	 y à m i ̠ |
nada	 n a d a |
sú̠rule	 s ú ̠ r u l e |
chö̀ke̠wa	 c h ö ̀ k e ̠ w a |
ìs	 ì s |
shkè̠na̠	 s h k è ̠ n a ̠ |
í̠ma̠	 í ̠ m a ̠ |
natividad	 n a t i v i d a d |
alto	 a l t o |
dùriña̠k	 d ù r i ñ a ̠ k |
wé̠jkë	 w é ̠ j k ë |
à̠ta̠	 à ̠ t a ̠ |
élke	 é l k e |
ma̠ñà̠t	 m a ̠ ñ à ̠ t |
ulàt	 u l à t |
shkö́k	 s h k ö ́ k |
ká̠pakö	 k á ̠ p a k ö |
wös	 w ö s |
dë́ka̠	 d ë ́ k a ̠ |
pàkö	 p à k ö |
me̠'	 m e ̠ ' |
ajkà	 a j k à |
a̠mé̠a̠t	 a ̠ m é ̠ a ̠ t |
dë́bitu̠	 d ë ́ b i t u ̠ |
dù	 d ù |
di'la	 d i ' l a |
dùri	 d ù r i |
akuö́k	 a k u ö ́ k |
me̠'ka̠	 m e ̠ ' k a ̠ |
mí̠chôka̠	 m í ̠ c h ô k a ̠ |
déka̠	 d é k a ̠ |
na̠mà̠söl	 n a ̠ m à ̠ s ö l |
ká̠bata	 k á ̠ b a t a |
tkër	 t k ë r |
ie'r	 i e ' r |
na̠mà̠ie	 n a ̠ m à ̠ i e |
e'r	 e ' r |
átuwö	 á t u w ö |
a̠me̠'a̠t	 a ̠ m e ̠ ' a ̠ t |
dalö̀	 d a l ö ̀ |
tulúr	 t u l ú r |
dalóie	 d a l ó i e |
ë́ltë	 ë ́ l t ë |
ditsö̀	 d i t s ö ̀ |
ajkö́nu̠k	 a j k ö ́ n u ̠ k |
ajkö́no̠	 a j k ö ́ n o ̠ |
na̠mé̠söl	 n a ̠ m é ̠ s ö l |
bë̂rie	 b ë ̂ r i e |
tso'tke	 t s o ' t k e |
ta̠'tke	 t a ̠ ' t k e |
blë'këkëpa	 b l ë ' k ë k ë p a |
i̠â̠chki	 i ̠ â ̠ c h k i |
ujché̠r	 u j c h é ̠ r |
sibö̀r	 s i b ö ̀ r |
pàka'	 p à k a ' |
pàkane̠	 p à k a n e ̠ |
tsítsir	 t s í t s i r |
wö́su̠k	 w ö ́ s u ̠ k |
ka̠nè̠blë'	 k a ̠ n è ̠ b l ë ' |
cha̠mù̠	 c h a ̠ m ù ̠ |
kuátkö̀ke̠	 k u á t k ö ̀ k e ̠ |
yawö́k	 y a w ö ́ k |
sè̠no̠	 s è ̠ n o ̠ |
mi̠kalè	 m i ̠ k a l è |
ikuö̀	 i k u ö ̀ |
itö̀tèke̠	 i t ö ̀ t è k e ̠ |
wë̀na̠la	 w ë ̀ n a ̠ l a |
ka̠nè̠we̠ke̠	 k a ̠ n è ̠ w e ̠ k e ̠ |
bíl	 b í l |
shkà̠ta̠ne̠	 s h k à ̠ t a ̠ n e ̠ |
dö̀mi̠	 d ö ̀ m i ̠ |
dabòm	 d a b ò m |
bö́yök	 b ö ́ y ö k |
sé̠r	 s é ̠ r |
tsè	 t s è |
yàmi̠pala	 y à m i ̠ p a l a |
ka̠nè̠we̠	 k a ̠ n è ̠ w e ̠ |
inú̠köl	 i n ú ̠ k ö l |
u̠'ù̠	 u ̠ ' ù ̠ |
wàto̠no̠	 w à t o ̠ n o ̠ |
ë́	 ë ́ |
wakpa	 w a k p a |
ka̠nè̠blö̀ke̠	 k a ̠ n è ̠ b l ö ̀ k e ̠ |
sa̠wè̠ke̠	 s a ̠ w è ̠ k e ̠ |
ka̠nè̠blöke̠	 k a ̠ n è ̠ b l ö k e ̠ |
àrrosla	 à r r o s l a |
kuatkè	 k u a t k è |
katàno̠	 k a t à n o ̠ |
alátsitsi	 a l á t s i t s i |
êla	 ê l a |
wêikö	 w ê i k ö |
pàkano̠	 p à k a n o ̠ |
démi̠	 d é m i ̠ |
e't	 e ' t |
tulúa̠t	 t u l ú a ̠ t |
sulàyibi	 s u l à y i b i |
katàblë'	 k a t à b l ë ' |
diö̀ya'	 d i ö ̀ y a ' |
suléyibi	 s u l é y i b i |
wébalök	 w é b a l ö k |
kirë̀rma̠pa	 k i r ë ̀ r m a ̠ p a |
i̠	 i ̠ |
bâwe̠	 b â w e ̠ |
tsë'ka	 t s ë ' k a |
mâ̠ma̠	 m â ̠ m a ̠ |
oro	 o r o |
kâne̠	 k â n e ̠ |
tsiríu̠k	 t s i r í u ̠ k |
kö́k	 k ö ́ k |
dalö̀iök	 d a l ö ̀ i ö k |
ajkö́nu̠ne̠	 a j k ö ́ n u ̠ n e ̠ |
sulû	 s u l û |
wámblër	 w á m b l ë r |
chö̀ulur	 c h ö ̀ u l u r |
dawö̀ulur	 d a w ö ̀ u l u r |
ñî̠köl	 ñ î ̠ k ö l |
i̠à̠rtse̠	 i ̠ à ̠ r t s e ̠ |
e'töm	 e ' t ö m |
ttö̀	 t t ö ̀ |
ie'rö	 i e ' r ö |
kuátkë	 k u á t k ë |
ulìta̠ne̠	 u l ì t a ̠ n e ̠ |
mì̠ne̠	 m ì ̠ n e ̠ |
kuátkök	 k u á t k ö k |
wa'ñe̠	 w a ' ñ e ̠ |
aì	 a ì |
chô	 c h ô |
wö̀wo̠	 w ö ̀ w o ̠ |
tsikírmi̠	 t s i k í r m i ̠ |
è̠ne̠wa̠mi̠	 è ̠ n e ̠ w a ̠ m i ̠ |
mì̠kalè	 m ì ̠ k a l è |
dè	 d è |
tsiríwe̠ke̠	 t s i r í w e ̠ k e ̠ |
tsiríwe̠	 t s i r í w e ̠ |
ké̠bata	 k é ̠ b a t a |
me̠'ie	 m e ̠ ' i e |
kiéka̠	 k i é k a ̠ |
kìne̠ka̠	 k ì n e ̠ k a ̠ |
kièka̠	 k i è k a ̠ |
à̠na̠wa̠	 à ̠ n a ̠ w a ̠ |
tsétse	 t s é t s e |
wámblö	 w á m b l ö |
kiàne̠	 k i à n e ̠ |
kë́sik	 k ë ́ s i k |
balö̀mi̠ne̠	 b a l ö ̀ m i ̠ n e ̠ |
ujtèmi̠	 u j t è m i ̠ |
wö́kir	 w ö ́ k i r |
dalë́wè̠	 d a l ë ́ w è ̠ |
kirìwe̠wa̠	 k i r ì w e ̠ w a ̠ |
kiár	 k i á r |
ká̠wö	 k á ̠ w ö |
mé̠rmi̠	 m é ̠ r m i ̠ |
da'	 d a ' |
kú̠nu̠k	 k ú ̠ n u ̠ k |
ajkö́ne̠	 a j k ö ́ n e ̠ |
dö̀pa	 d ö ̀ p a |
ska	 s k a |
wake'	 w a k e ' |
à̠te̠tke	 à ̠ t e ̠ t k e |
itö̀	 i t ö ̀ |
es	 e s |
érë	 é r ë |
ka̠nè̠	 k a ̠ n è ̠ |
ka̠nè̠wè̠mi̠	 k a ̠ n è ̠ w è ̠ m i ̠ |
púchi	 p ú c h i |
tsikìnu̠k	 t s i k ì n u ̠ k |
sha̠lê̠lê̠	 s h a ̠ l ê ̠ l ê ̠ |
ë	 ë |
kicha	 k i c h a |
chö	 c h ö |
shà̠	 s h à ̠ |
báne̠t	 b á n e ̠ t |
cha̠mù̠la	 c h a ̠ m ù ̠ l a |
kuátkèmi̠	 k u á t k è m i ̠ |
kuátke	 k u á t k e |
wö̀batse	 w ö ̀ b a t s e |
ésela	 é s e l a |
tsikír	 t s i k í r |
mí̠tkene̠	 m í ̠ t k e n e ̠ |
mú̠	 m ú ̠ |
kuála	 k u á l a |
ka̠nè̠o̠rmi̠	 k a ̠ n è ̠ o ̠ r m i ̠ |
iku̠á̠ki̠	 i k u ̠ á ̠ k i ̠ |
sé̠râ	 s é ̠ r â |
a̠mù̠bli	 a ̠ m ù ̠ b l i |
coroma	 c o r o m a |
i̠à̠ne̠	 i ̠ à ̠ n e ̠ |
ma̠nè̠ne̠tsa̠	 m a ̠ n è ̠ n e ̠ t s a ̠ |
bribriwak	 b r i b r i w a k |
bikéitse̠	 b i k é i t s e ̠ |
a̠mè̠ne̠a̠t	 a ̠ m è ̠ n e ̠ a ̠ t |
a̠mè̠ne̠	 a ̠ m è ̠ n e ̠ |
ië̀ka̠	 i ë ̀ k a ̠ |
ku̠é̠i̠	 k u ̠ é ̠ i ̠ |
siempre	 s i e m p r e |
alè	 a l è |
rë	 r ë |
të̀	 t ë ̀ |
tu̠è̠	 t u ̠ è ̠ |
kuáble	 k u á b l e |
átu	 á t u |
ali'	 a l i ' |
apì	 a p ì |
sawák	 s a w á k |
wè̠	 w è ̠ |
ajkàyë'	 a j k à y ë ' |
ka̠nè̠ble	 k a ̠ n è ̠ b l e |
ala'rla	 a l a ' r l a |
tièra	 t i è r a |
êjkë	 ê j k ë |
ká̠ñi̠rke̠	 k á ̠ ñ i ̠ r k e ̠ |
ká̠tuírke̠	 k á ̠ t u í r k e ̠ |
kó̠	 k ó ̠ |
íjkë	 í j k ë |
ma̠lé̠pa	 m a ̠ l é ̠ p a |
wö̀blao̠'	 w ö ̀ b l a o ̠ ' |
ka̠nè̠blök	 k a ̠ n è ̠ b l ö k |
yulö́k	 y u l ö ́ k |
àk	 à k |
balèku̠	 b a l è k u ̠ |
balè	 b a l è |
sulûë	 s u l û ë |
ka̠nè̠bleke̠	 k a ̠ n è ̠ b l e k e ̠ |
ajkàche	 a j k à c h e |
yö̂mi̠	 y ö ̂ m i ̠ |
yö̀ne̠mi̠	 y ö ̀ n e ̠ m i ̠ |
varios	 v a r i o s |
wö́ulârke̠	 w ö ́ u l â r k e ̠ |
wö́ulâne̠	 w ö ́ u l â n e ̠ |
tsö́k	 t s ö ́ k |
erë	 e r ë |
wö̂ikèke̠	 w ö ̂ i k è k e ̠ |
wö́ulâo̠	 w ö ́ u l â o ̠ |
wö́ulâo̠mi̠	 w ö ́ u l â o ̠ m i ̠ |
é̠ma̠	 é ̠ m a ̠ |
raúl	 r a ú l |
méndez	 m é n d e z |
ujchè̠n	 u j c h è ̠ n |
à̠	 à ̠ |
bikéitsèke̠	 b i k é i t s è k e ̠ |
yàli	 y à l i |
apàke	 a p à k e |
alatsítsi	 a l a t s í t s i |
wö̂ikmi̠	 w ö ̂ i k m i ̠ |
alàtsítsi	 a l à t s í t s i |
wö̂ik	 w ö ̂ i k |
bitu̠	 b i t u ̠ |
wö̂ike	 w ö ̂ i k e |
wö̂ìna̠	 w ö ̂ ì n a ̠ |
tka'	 t k a ' |
tawàlia	 t a w à l i a |
ñé̠es	 ñ é ̠ e s |
kë́këpala	 k ë ́ k ë p a l a |
àlim	 à l i m |
pa	 p a |
kö̀chi	 k ö ̀ c h i |
krò	 k r ò |
bàka	 b à k a |
kabàiö	 k a b à i ö |
kalö̀	 k a l ö ̀ |
o̠'mi̠k	 o ̠ ' m i ̠ k |
kàlkö	 k à l k ö |
dóma̠le̠	 d ó m a ̠ l e ̠ |
ka̠nè̠wo̠	 k a ̠ n è ̠ w o ̠ |
ichö́kle	 i c h ö ́ k l e |
ró	 r ó |
shirë́kö	 s h i r ë ́ k ö |
klòkö	 k l ò k ö |
shu̠lé̠	 s h u ̠ l é ̠ |
sö̀kkö	 s ö ̀ k k ö |
dapáwe̠ma̠le̠	 d a p á w e ̠ m a ̠ l e ̠ |
páliu̠köl	 p á l i u ̠ k ö l |
aîkö	 a î k ö |
bitù̠ke̠ma̠le̠	 b i t ù ̠ k e ̠ m a ̠ l e ̠ |
tsè̠	 t s è ̠ |
bítkuak	 b í t k u a k |
bö́tkuak	 b ö ́ t k u a k |
tkë́yök	 t k ë ́ y ö k |
sìtla	 s ì t l a |
wö̂iko	 w ö ̂ i k o |
étkuak	 é t k u a k |
tkabë̀	 t k a b ë ̀ |
kuéwa̠	 k u é w a ̠ |
ie'par	 i e ' p a r |
tsî̠	 t s î ̠ |
âr	 â r |
apàkö	 a p à k ö |
bulù	 b u l ù |
tsítsipala	 t s í t s i p a l a |
talâr	 t a l â r |
pàtu	 p à t u |
pú̠	 p ú ̠ |
irö̀	 i r ö ̀ |
cómo	 c ó m o |
se	 s e |
llama	 l l a m a |
kayö́	 k a y ö ́ |
dùsi̠a̠	 d ù s i ̠ a ̠ |
pík	 p í k |
ku̠ka̠'	 k u ̠ k a ̠ ' |
wö́ni̠k	 w ö ́ n i ̠ k |
pulë̀	 p u l ë ̀ |
tsítsipa	 t s í t s i p a |
kalö'wo̠	 k a l ö ' w o ̠ |
shù̠	 s h ù ̠ |
mâ̠tkle	 m â ̠ t k l e |
apàto	 a p à t o |
na̠mù̠	 n a ̠ m ù ̠ |
akà	 a k à |
talók	 t a l ó k |
akàla	 a k à l a |
pà̠rlor	 p à ̠ r l o r |
wë́	 w ë ́ |
jueputa	 j u e p u t a |
si̠nà̠s	 s i ̠ n à ̠ s |
kö	 k ö |
vea	 v e a |
bakèla	 b a k è l a |
bakè	 b a k è |
bika'	 b i k a ' |
yë̀ñapala	 y ë ̀ ñ a p a l a |
pàtököl	 p à t ö k ö l |
wéblö	 w é b l ö |
tsè̠bitu̠	 t s è ̠ b i t u ̠ |
dalé	 d a l é |
ujtö́	 u j t ö ́ |
tsî̠ne̠t	 t s î ̠ n e ̠ t |
krá	 k r á |
wö́rki̠	 w ö ́ r k i ̠ |
kuë̀	 k u ë ̀ |
wì̠m	 w ì ̠ m |
wìm	 w ì m |
kachúk	 k a c h ú k |
alö̀buk	 a l ö ̀ b u k |
urrì	 u r r ì |
dakòlum	 d a k ò l u m |
stsí	 s t s í |
wàpie	 w à p i e |
ês	 ê s |
biké	 b i k é |
apàyo	 a p à y o |
wé̠s	 w é ̠ s |
batséi	 b a t s é i |
iki'wè̠ka̠	 i k i ' w è ̠ k a ̠ |
iska	 i s k a |
wé̠ma̠le̠	 w é ̠ m a ̠ l e ̠ |
tsé̠mi̠	 t s é ̠ m i ̠ |
tsule'	 t s u l e ' |
e'ta	 e ' t a |
shù̠aline̠	 s h ù ̠ a l i n e ̠ |
bikéitse	 b i k é i t s e |
batsé	 b a t s é |
bukulú	 b u k u l ú |
ña̠là̠	 ñ a ̠ l à ̠ |
tse̠ke̠	 t s e ̠ k e ̠ |
katúr	 k a t ú r |
klö́m	 k l ö ́ m |
klö́bli	 k l ö ́ b l i |
sé̠se̠	 s é ̠ s e ̠ |
sé̠se̠la	 s é ̠ s e ̠ l a |
yè	 y è |
kuáblök	 k u á b l ö k |
buë'	 b u ë ' |
kuá	 k u á |
wé̠alê	 w é ̠ a l ê |
el	 e l |
muchacho	 m u c h a c h o |
akë́chkeël	 a k ë ́ c h k e ë l |
êskapë	 ê s k a p ë |
tsîrlaël	 t s î r l a ë l |
stsa'wö	 s t s a ' w ö |
colegio	 c o l e g i o |
ka̠nè̠blö	 k a ̠ n è ̠ b l ö |
wö̀blane̠	 w ö ̀ b l a n e ̠ |
ñè̠	 ñ è ̠ |
ñè̠ke̠	 ñ è ̠ k e ̠ |
na̠i̠'chka	 n a ̠ i ̠ ' c h k a |
katàne̠	 k a t à n e ̠ |
à̠a̠	 à ̠ a ̠ |
na̠i̠'	 n a ̠ i ̠ ' |
ditsö̀wöpa	 d i t s ö ̀ w ö p a |
u̠jú̠	 u ̠ j ú ̠ |
tö́	 t ö ́ |
ká̠	 k á ̠ |
tèröl	 t è r ö l |
se'	 s e ' |
e's	 e ' s |
tër	 t ë r |
idirla	 i d i r l a |
e'	 e ' |
dör	 d ö r |
ie'	 i e ' |
dawè	 d a w è |
tè	 t è |
pú	 p ú |
irir	 i r i r |
kàl	 k à l |
wö	 w ö |
iene̠	 i e n e ̠ |
ie	 i e |
i	 i |
wà	 w à |
bë̂r	 b ë ̂ r |
yë̂ar	 y ë ̂ a r |
e'tk	 e ' t k |
ë̀	 ë ̀ |
ú̠jù̠	 ú ̠ j ù ̠ |
tsiö̀	 t s i ö ̀ |
ù	 ù |
batà	 b a t à |
uju	 u j u |
e'kët	 e ' k ë t |
ta̠	 t a ̠ |
bua'	 b u a ' |
wö̀na̠	 w ö ̀ n a ̠ |
dayë̀	 d a y ë ̀ |
yö̀ne̠	 y ö ̀ n e ̠ |
sibö̀	 s i b ö ̀ |
a̠	 a ̠ |
ché	 c h é |
be'	 b e ' |
e̠'	 e ̠ ' |
shkö́bitu̠	 s h k ö ́ b i t u ̠ |
a̠wí̠	 a ̠ w í ̠ |
kò̠s	 k ò ̠ s |
ki̠	 k i ̠ |
dawás	 d a w á s |
tso'	 t s o ' |
sìkuapa	 s ì k u a p a |
icha	 i c h a |
itö̀ièke̠	 i t ö ̀ i è k e ̠ |
no	 n o |
ì	 ì |
se'la	 s e ' l a |
yö́	 y ö ́ |
söla	 s ö l a |
sö	 s ö |
balo'rila	 b a l o ' r i l a |
buáala	 b u á a l a |
balo'ri	 b a l o ' r i |
sharila	 s h a r i l a |
a̠là̠chkala	 a ̠ l à ̠ c h k a l a |
ta̠la	 t a ̠ l a |
ye'	 y e ' |
dawèka̠la	 d a w è k a ̠ l a |
aláköla	 a l á k ö l a |
sû̠	 s û ̠ |
sula'	 s u l a ' |
ichàkökala	 i c h à k ö k a l a |
kirë̀rma̠	 k i r ë ̀ r m a ̠ |
kirë̀rma̠la	 k i r ë ̀ r m a ̠ l a |
wö̀	 w ö ̀ |
a̠la	 a ̠ l a |
kë̀la	 k ë ̀ l a |
aë̀rwala	 a ë ̀ r w a l a |
töla	 t ö l a |
ìla	 ì l a |
aë̀	 a ë ̀ |
ijtsèmi̠la	 i j t s è m i ̠ l a |
à	 à |
kë́këpa	 k ë ́ k ë p a |
i̠'ñe̠	 i ̠ ' ñ e ̠ |
sa'	 s a ' |
tö	 t ö |
mí̠a̠	 m í ̠ a ̠ |
wë'stela	 w ë ' s t e l a |
ta̠î̠ë	 t a ̠ î ̠ ë |
ujté	 u j t é |
ta̠î̠	 t a ̠ î ̠ |
kabéne̠	 k a b é n e ̠ |
we'ine̠	 w e ' i n e ̠ |
si̠à̠rë	 s i ̠ à ̠ r ë |
yàmi̠pa	 y à m i ̠ p a |
we'ike	 w e ' i k e |
wa̠	 w a ̠ |
bua'ë	 b u a ' ë |
kí̠mè̠ke̠	 k í ̠ m è ̠ k e ̠ |
ku̠é̠ki̠	 k u ̠ é ̠ k i ̠ |
é̠n	 é ̠ n |
chak	 c h a k |
kiè	 k i è |
alà	 a l à |
kie	 k i e |
jesús	 j e s ú s |
amén	 a m é n |
ké̠we	 k é ̠ w e |
tsiru'	 t s i r u ' |
tèke̠	 t è k e ̠ |
tsakèke̠	 t s a k è k e ̠ |
é	 é |
ma̠	 m a ̠ |
shkö́wè̠ke̠	 s h k ö ́ w è ̠ k e ̠ |
síkwa	 s í k w a |
të́rulewa̠	 t ë ́ r u l e w a ̠ |
ékëpa	 é k ë p a |
mè̠ke̠ttsa̠	 m è ̠ k e ̠ t t s a ̠ |
dìba	 d ì b a |
sìne̠	 s ì n e ̠ |
kukèke̠	 k u k è k e ̠ |
wö̀ppèke̠	 w ö ̀ p p è k e ̠ |
wèke̠	 w è k e ̠ |
tabèchka	 t a b è c h k a |
ki̠ka	 k i ̠ k a |
blôblô	 b l ô b l ô |
chkà	 c h k à |
páköl	 p á k ö l |
mi̠	 m i ̠ |
mè̠ke̠ka̠	 m è ̠ k e ̠ k a ̠ |
bö'	 b ö ' |
daléwa	 d a l é w a |
mo̠ló̠tsmo̠ló̠ts	 m o ̠ l ó ̠ t s m o ̠ l ó ̠ t s |
íyi	 í y i |
ièka̠	 i è k a ̠ |
i̠a̠	 i ̠ a ̠ |
sìkua	 s ì k u a |
canela	 c a n e l a |
e̠ma̠	 e ̠ m a ̠ |
dlásháwö	 d l á s h á w ö |
shá̠mé̠la	 s h á ̠ m é ̠ l a |
apà	 a p à |
butrèke̠wa̠	 b u t r è k e ̠ w a ̠ |
yë́jkuö	 y ë ́ j k u ö |
wa	 w a |
ta̠wè̠ke̠	 t a ̠ w è ̠ k e ̠ |
bulu'pa	 b u l u ' p a |
bueno	 b u e n o |
í̠e̠	 í ̠ e ̠ |
rè	 r è |
e'ta̠	 e ' t a ̠ |
yulár	 y u l á r |
wö̀ke̠	 w ö ̀ k e ̠ |
wè̠s	 w è ̠ s |
a'r	 a ' r |
sa̠wè̠	 s a ̠ w è ̠ |
bribripa	 b r i b r i p a |
ák	 á k |
mè̠a̠t	 m è ̠ a ̠ t |
wö́köl	 w ö ́ k ö l |
kë̀	 k ë ̀ |
ô̠ka	 ô ̠ k a |
mè̠ne̠a̠t	 m è ̠ n e ̠ a ̠ t |
wö́k	 w ö ́ k |
a̠wì̠	 a ̠ w ì ̠ |
pàke	 p à k e |
rë'ka̠	 r ë ' k a ̠ |
dià	 d i à |
kièke̠	 k i è k e ̠ |
ká̠ska	 k á ̠ s k a |
ma̠nè̠te̠	 m a ̠ n è ̠ t e ̠ |
ditsö̀wö	 d i t s ö ̀ w ö |
ikuö̀wö	 i k u ö ̀ w ö |
ése	 é s e |
ditséwö	 d i t s é w ö |
mì̠ka̠	 m ì ̠ k a ̠ |
tskìne̠	 t s k ì n e ̠ |
sulàyöm	 s u l à y ö m |
me̠'a̠t	 m e ̠ ' a ̠ t |
ñá̠no̠	 ñ á ̠ n o ̠ |
katáno̠	 k a t á n o ̠ |
chkö́köl	 c h k ö ́ k ö l |
sè̠nu̠köl	 s è ̠ n u ̠ k ö l |
î̠ñe̠	 î ̠ ñ e ̠ |
katèke̠	 k a t è k e ̠ |
mì̠k	 m ì ̠ k |
nê̠ne̠	 n ê ̠ n e ̠ |
hasta	 h a s t a |
rö	 r ö |
sì̠na̠	 s ì ̠ n a ̠ |
éjkë	 é j k ë |
i̠à̠na̠	 i ̠ à ̠ n a ̠ |
tso'se̠n	 t s o ' s e ̠ n |
ùrke̠	 ù r k e ̠ |
ujtö̀ie	 u j t ö ̀ i e |
sé̠rke̠	 s é ̠ r k e ̠ |
bùsila	 b ù s i l a |
wö́ulâù̠ke̠	 w ö ́ u l â ù ̠ k e ̠ |
ö	 ö |
bùsi	 b ù s i |
ulà	 u l à |
batsèmi̠	 b a t s è m i ̠ |
mà̠so	 m à ̠ s o |
kú̠rmi̠	 k ú ̠ r m i ̠ |
wö́ulâna̠tketke	 w ö ́ u l â n a ̠ t k e t k e |
éki	 é k i |
sé̠	 s é ̠ |
tsè̠ke̠	 t s è ̠ k e ̠ |
éyökie	 é y ö k i e |
dö̀ka̠	 d ö ̀ k a ̠ |
ékölëme̠	 é k ö l ë m e ̠ |
rö̀	 r ö ̀ |
ké̠	 k é ̠ |
blo'	 b l o ' |
yèke̠	 y è k e ̠ |
chkö̀ke̠rak	 c h k ö ̀ k e ̠ r a k |
tso'rak	 t s o ' r a k |
ñî̠	 ñ î ̠ |
ñì̠	 ñ ì ̠ |
kímu̠kdak	 k í m u ̠ k d a k |
wé̠se	 w é ̠ s e |
yìr	 y ì r |
ièke̠	 i è k e ̠ |
ñé̠	 ñ é ̠ |
wé̠shke̠	 w é ̠ s h k e ̠ |
mì̠kle	 m ì ̠ k l e |
a̠wí̠es	 a ̠ w í ̠ e s |
e'rör	 e ' r ö r |
wé̠	 w é ̠ |
e'köl	 e ' k ö l |
yì	 y ì |
bua'r	 b u a ' r |
kià̠na̠	 k i à ̠ n a ̠ |
e̠'rö	 e ̠ ' r ö |
wákpa	 w á k p a |
sé̠ndak	 s é ̠ n d a k |
ujtö̀	 u j t ö ̀ |
sé̠n	 s é ̠ n |
tsikìne̠	 t s i k ì n e ̠ |
amù̠bli	 a m ù ̠ b l i |
talàne̠	 t a l à n e ̠ |
mama	 m a m a |
bö̀k	 b ö ̀ k |
ma̠nè̠ta̠	 m a ̠ n è ̠ t a ̠ |
ñe̠'	 ñ e ̠ ' |
klö̀	 k l ö ̀ |
este	 e s t e |
boca	 b o c a |
urén	 u r é n |
ká̠batà	 k á ̠ b a t à |
ma̠nè̠t	 m a ̠ n è ̠ t |
kibí	 k i b í |
que	 q u e |
ya	 y a |
yö	 y ö |
esposo	 e s p o s o |
ta̠'	 t a ̠ ' |
dë'rö	 d ë ' r ö |
tsú̠k	 t s ú ̠ k |
entonces	 e n t o n c e s |
dìwö	 d ì w ö |
dé	 d é |
kúkur	 k ú k u r |
pàköl	 p à k ö l |
i'	 i ' |
pero	 p e r o |
dë'	 d ë ' |
dë'tsa̠	 d ë ' t s a ̠ |
sè̠ne̠	 s è ̠ n e ̠ |
yàk	 y à k |
sa̠	 s a ̠ |
casi	 c a s i |
e'k	 e ' k |
ukö̀ki̠	 u k ö ̀ k i ̠ |
yö'	 y ö ' |
ahora	 a h o r a |
sí	 s í |
tkë̀r	 t k ë ̀ r |
ká̠m	 k á ̠ m |
chö̀wa	 c h ö ̀ w a |
yë́	 y ë ́ |
si̠wa̠'	 s i ̠ w a ̠ ' |
të'r	 t ë ' r |
ala'rala	 a l a ' r a l a |
tskìna̠	 t s k ì n a ̠ |
kù̠na̠	 k ù ̠ n a ̠ |
ie'pa	 i e ' p a |
hospital	 h o s p i t a l |
talàna̠	 t a l à n a ̠ |
wö́ulâa̠'	 w ö ́ u l â a ̠ ' |
sa̠ú̠k	 s a ̠ ú ̠ k |
pôó̠rulur	 p ô ó ̠ r u l u r |
kibìna̠	 k i b ì n a ̠ |
mí̠tke	 m í ̠ t k e |
solo	 s o l o |
à̠te̠	 à ̠ t e ̠ |
e'köla	 e ' k ö l a |
porque	 p o r q u e |
dë'u̠ntu	 d ë ' u ̠ n t u |
e'tala	 e ' t a l a |
chóla	 c h ó l a |
chë'wa	 c h ë ' w a |
ajá	 a j á |
ujú	 u j ú |
como	 c o m o |
ajké̠	 a j k é ̠ |
propio	 p r o p i o |
ye'r	 y e ' r |
mí̠k	 m í ̠ k |
alí	 a l í |
cortadora	 c o r t a d o r a |
té	 t é |
kókó	 k ó k ó |
détsa̠	 d é t s a ̠ |
tal	 t a l |
vez	 v e z |
saco	 s a c o |
be'r	 b e ' r |
mé̠a̠t	 m é ̠ a ̠ t |
dö̀	 d ö ̀ |
su̠lì̠tu	 s u ̠ l ì ̠ t u |
mé̠r	 m é ̠ r |
síu̠k	 s í u ̠ k |
bétk	 b é t k |
sìna̠wa̠	 s ì n a ̠ w a ̠ |
sìna̠	 s ì n a ̠ |
tkë́l	 t k ë ́ l |
kukèke̠tke	 k u k è k e ̠ t k e |
ù̠	 ù ̠ |
bá	 b á |
sa̠ú̠	 s a ̠ ú ̠ |
kukö́k	 k u k ö ́ k |
katùna̠	 k a t ù n a ̠ |
wö̀ishchèke̠	 w ö ̀ i s h c h è k e ̠ |
ajkuö́lit	 a j k u ö ́ l i t |
yéulur	 y é u l u r |
máquina	 m á q u i n a |
sa'r	 s a ' r |
i̠â̠chkí	 i ̠ â ̠ c h k í |
kukö̀ke̠	 k u k ö ̀ k e ̠ |
a'	 a ' |
pàkeke̠	 p à k e k e ̠ |
tskírke̠	 t s k í r k e ̠ |
chè	 c h è |
mí̠ka̠	 m í ̠ k a ̠ |
e'rö	 e ' r ö |
ñá̠	 ñ á ̠ |
a̠mì̠	 a ̠ m ì ̠ |
kiàna̠	 k i à n a ̠ |
pàkuemle̠	 p à k u e m l e ̠ |
óköpa	 ó k ö p a |
rë́ka̠	 r ë ́ k a ̠ |
wíköl	 w í k ö l |
pàtkeke̠	 p à t k e k e ̠ |
mè̠bitu̠	 m è ̠ b i t u ̠ |
yawè	 y a w è |
di'	 d i ' |
rë́ka̠i̠a̠	 r ë ́ k a ̠ i ̠ a ̠ |
pà	 p à |
sùne̠	 s ù n e ̠ |
ka̠nè̠u̠k	 k a ̠ n è ̠ u ̠ k |
bitè̠	 b i t è ̠ |
pàtkebitu̠	 p à t k e b i t u ̠ |
chèa̠t	 c h è a ̠ t |
ké	 k é |
ka̠nè̠u̠	 k a ̠ n è ̠ u ̠ |
mí̠tkemu̠le̠	 m í ̠ t k e m u ̠ l e ̠ |
ujtè	 u j t è |
mí̠ke̠mu̠le̠	 m í ̠ k e ̠ m u ̠ l e ̠ |
satë̀	 s a t ë ̀ |
kìta̠	 k ì t a ̠ |
mé̠mu̠le̠	 m é ̠ m u ̠ l e ̠ |
sa̠wé̠	 s a ̠ w é ̠ |
mò̠ki̠	 m ò ̠ k i ̠ |
yë'	 y ë ' |
se'r	 s e ' r |
ka̠nè̠o̠'	 k a ̠ n è ̠ o ̠ ' |
kí̠	 k í ̠ |
bakò̠s	 b a k ò ̠ s |
a̠ñì̠es	 a ̠ ñ ì ̠ e s |
i̠ù̠te	 i ̠ ù ̠ t e |
chèrak	 c h è r a k |
idir	 i d i r |
katè	 k a t è |
ajkë́u̠k	 a j k ë ́ u ̠ k |
kàne̠	 k à n e ̠ |
a̠ñì̠	 a ̠ ñ ì ̠ |
yö̀ki̠	 y ö ̀ k i ̠ |
à̠s	 à ̠ s |
tsikìna̠	 t s i k ì n a ̠ |
réwa̠	 r é w a ̠ |
sè̠nu̠k	 s è ̠ n u ̠ k |
dalë́ri	 d a l ë ́ r i |
dalö̀iökdak	 d a l ö ̀ i ö k d a k |
yë'a̠t	 y ë ' a ̠ t |
tsikírke̠	 t s i k í r k e ̠ |
ñé̠e̠	 ñ é ̠ e ̠ |
tsá̠we	 t s á ̠ w e |
dë́bitu̠dak	 d ë ́ b i t u ̠ d a k |
bö́l	 b ö ́ l |
ma̠ñá̠l	 m a ̠ ñ á ̠ l |
ë̀me̠	 ë ̀ m e ̠ |
e'pa	 e ' p a |
wé	 w é |
wéla	 w é l a |
tkë́rka̠	 t k ë ́ r k a ̠ |
tkë́rka̠rak	 t k ë ́ r k a ̠ r a k |
alákölpa	 a l á k ö l p a |
bitu̠ke̠rak	 b i t u ̠ k e ̠ r a k |
ala'r	 a l a ' r |
tsikírke̠tke	 t s i k í r k e ̠ t k e |
awá	 a w á |
óköm	 ó k ö m |
kapèblök	 k a p è b l ö k |
bátsena̠mu̠le̠	 b á t s e n a ̠ m u ̠ l e ̠ |
ka̠nè̠wè̠ke̠	 k a ̠ n è ̠ w è ̠ k e ̠ |
wák	 w á k |
ka'	 k a ' |
bák	 b á k |
tsîr	 t s î r |
ká̠mî̠ë	 k á ̠ m î ̠ ë |
cabagra	 c a b a g r a |
ajkö̀	 a j k ö ̀ |
a̠wí̠she̠t	 a ̠ w í ̠ s h e ̠ t |
ë̀ka̠	 ë ̀ k a ̠ |
santa	 s a n t a |
elena	 e l e n a |
puente	 p u e n t e |
mí̠ke̠	 m í ̠ k e ̠ |
mú̠köl	 m ú ̠ k ö l |
talâo̠	 t a l â o ̠ |
mì̠	 m ì ̠ |
êköl	 ê k ö l |
wë̂i̠a̠	 w ë ̂ i ̠ a ̠ |
escuela	 e s c u e l a |
skà	 s k à |
ichàkeke̠	 i c h à k e k e ̠ |
wö́blar	 w ö ́ b l a r |
ni̠mà̠	 n i ̠ m à ̠ |
kalíu̠k	 k a l í u ̠ k |
mí̠kalè	 m í ̠ k a l è |
ka̠ñí̠k	 k a ̠ ñ í ̠ k |
bàn	 b à n |
ùyöm	 ù y ö m |
wé̠alè	 w é ̠ a l è |
dë́rule	 d ë ́ r u l e |
apàkö́	 a p à k ö ́ |
ña̠	 ñ a ̠ |
kalíwe̠	 k a l í w e ̠ |
ukö̀	 u k ö ̀ |
mí̠	 m í ̠ |
bö	 b ö |
wö̀iewa̠	 w ö ̀ i e w a ̠ |
á̠jà̠	 á ̠ j à ̠ |
pues	 p u e s |
té̠rke̠	 t é ̠ r k e ̠ |
ké̠kra	 k é ̠ k r a |
diö́	 d i ö ́ |
río	 r í o |
y	 y |
cordillera	 c o r d i l l e r a |
mi̠k	 m i ̠ k |
muchos	 m u c h o s |
digamos	 d i g a m o s |
i̠â̠i̠â̠	 i ̠ â ̠ i ̠ â ̠ |
jké̠	 j k é ̠ |
sàl	 s à l |
ö̀k	 ö ̀ k |
íyiwak	 í y i w a k |
êrë	 ê r ë |
chìchi	 c h ì c h i |
yë́s	 y ë ́ s |
ajkè̠n	 a j k è ̠ n |
ni̠mé̠i	 n i ̠ m é ̠ i |
mu̠lû̠wak	 m u ̠ l û ̠ w a k |
dakòlwak	 d a k ò l w a k |
wàtak	 w à t a k |
kàlni̠me̠	 k à l n i ̠ m e ̠ |
bulë̀rwak	 b u l ë ̀ r w a k |
ñí̠we	 ñ í ̠ w e |
na̠ñé̠we	 n a ̠ ñ é ̠ w e |
mì̠kalê	 m ì ̠ k a l ê |
ñê̠es	 ñ ê ̠ e s |
bìt	 b ì t |
ulàttöu̠k	 u l à t t ö u ̠ k |
aû	 a û |
bö̀tk	 b ö ̀ t k |
ma̠ñà̠tk	 m a ̠ ñ à ̠ t k |
tsé̠a̠t	 t s é ̠ a ̠ t |
kapë́rule	 k a p ë ́ r u l e |
kapö̀ke̠	 k a p ö ̀ k e ̠ |
sík	 s í k |
kö̀	 k ö ̀ |
yawèka̠	 y a w è k a ̠ |
dikì̠	 d i k ì ̠ |
chkö̀	 c h k ö ̀ |
mí̠rule	 m í ̠ r u l e |
àrros	 à r r o s |
así	 a s í |
kalö́m	 k a l ö ́ m |
mismo	 m i s m o |
sí̠	 s í ̠ |
dapö̀	 d a p ö ̀ |
ku̠é̠	 k u ̠ é ̠ |
bìl	 b ì l |
yàmi̠	 y à m i ̠ |
nada	 n a d a |
sú̠rule	 s ú ̠ r u l e |
chö̀ke̠wa	 c h ö ̀ k e ̠ w a |
ìs	 ì s |
shkè̠na̠	 s h k è ̠ n a ̠ |
í̠ma̠	 í ̠ m a ̠ |
natividad	 n a t i v i d a d |
alto	 a l t o |
dùriña̠k	 d ù r i ñ a ̠ k |
wé̠jkë	 w é ̠ j k ë |
à̠ta̠	 à ̠ t a ̠ |
élke	 é l k e |
ma̠ñà̠t	 m a ̠ ñ à ̠ t |
ulàt	 u l à t |
shkö́k	 s h k ö ́ k |
ká̠pakö	 k á ̠ p a k ö |
wös	 w ö s |
dë́ka̠	 d ë ́ k a ̠ |
pàkö	 p à k ö |
me̠'	 m e ̠ ' |
ajkà	 a j k à |
a̠mé̠a̠t	 a ̠ m é ̠ a ̠ t |
dë́bitu̠	 d ë ́ b i t u ̠ |
dù	 d ù |
di'la	 d i ' l a |
dùri	 d ù r i |
akuö́k	 a k u ö ́ k |
me̠'ka̠	 m e ̠ ' k a ̠ |
mí̠chôka̠	 m í ̠ c h ô k a ̠ |
déka̠	 d é k a ̠ |
na̠mà̠söl	 n a ̠ m à ̠ s ö l |
ká̠bata	 k á ̠ b a t a |
tkër	 t k ë r |
ie'r	 i e ' r |
na̠mà̠ie	 n a ̠ m à ̠ i e |
e'r	 e ' r |
átuwö	 á t u w ö |
a̠me̠'a̠t	 a ̠ m e ̠ ' a ̠ t |
dalö̀	 d a l ö ̀ |
tulúr	 t u l ú r |
dalóie	 d a l ó i e |
ë́ltë	 ë ́ l t ë |
ditsö̀	 d i t s ö ̀ |
ajkö́nu̠k	 a j k ö ́ n u ̠ k |
ajkö́no̠	 a j k ö ́ n o ̠ |
na̠mé̠söl	 n a ̠ m é ̠ s ö l |
bë̂rie	 b ë ̂ r i e |
tso'tke	 t s o ' t k e |
ta̠'tke	 t a ̠ ' t k e |
blë'këkëpa	 b l ë ' k ë k ë p a |
i̠â̠chki	 i ̠ â ̠ c h k i |
ujché̠r	 u j c h é ̠ r |
sibö̀r	 s i b ö ̀ r |
pàka'	 p à k a ' |
pàkane̠	 p à k a n e ̠ |
tsítsir	 t s í t s i r |
wö́su̠k	 w ö ́ s u ̠ k |
ka̠nè̠blë'	 k a ̠ n è ̠ b l ë ' |
cha̠mù̠	 c h a ̠ m ù ̠ |
kuátkö̀ke̠	 k u á t k ö ̀ k e ̠ |
yawö́k	 y a w ö ́ k |
sè̠no̠	 s è ̠ n o ̠ |
mi̠kalè	 m i ̠ k a l è |
ikuö̀	 i k u ö ̀ |
itö̀tèke̠	 i t ö ̀ t è k e ̠ |
wë̀na̠la	 w ë ̀ n a ̠ l a |
ka̠nè̠we̠ke̠	 k a ̠ n è ̠ w e ̠ k e ̠ |
bíl	 b í l |
shkà̠ta̠ne̠	 s h k à ̠ t a ̠ n e ̠ |
dö̀mi̠	 d ö ̀ m i ̠ |
dabòm	 d a b ò m |
bö́yök	 b ö ́ y ö k |
sé̠r	 s é ̠ r |
tsè	 t s è |
yàmi̠pala	 y à m i ̠ p a l a |
ka̠nè̠we̠	 k a ̠ n è ̠ w e ̠ |
inú̠köl	 i n ú ̠ k ö l |
u̠'ù̠	 u ̠ ' ù ̠ |
wàto̠no̠	 w à t o ̠ n o ̠ |
ë́	 ë ́ |
wakpa	 w a k p a |
ka̠nè̠blö̀ke̠	 k a ̠ n è ̠ b l ö ̀ k e ̠ |
sa̠wè̠ke̠	 s a ̠ w è ̠ k e ̠ |
ka̠nè̠blöke̠	 k a ̠ n è ̠ b l ö k e ̠ |
àrrosla	 à r r o s l a |
kuatkè	 k u a t k è |
katàno̠	 k a t à n o ̠ |
alátsitsi	 a l á t s i t s i |
êla	 ê l a |
wêikö	 w ê i k ö |
pàkano̠	 p à k a n o ̠ |
démi̠	 d é m i ̠ |
e't	 e ' t |
tulúa̠t	 t u l ú a ̠ t |
sulàyibi	 s u l à y i b i |
katàblë'	 k a t à b l ë ' |
diö̀ya'	 d i ö ̀ y a ' |
suléyibi	 s u l é y i b i |
wébalök	 w é b a l ö k |
kirë̀rma̠pa	 k i r ë ̀ r m a ̠ p a |
i̠	 i ̠ |
bâwe̠	 b â w e ̠ |
tsë'ka	 t s ë ' k a |
mâ̠ma̠	 m â ̠ m a ̠ |
oro	 o r o |
kâne̠	 k â n e ̠ |
tsiríu̠k	 t s i r í u ̠ k |
kö́k	 k ö ́ k |
dalö̀iök	 d a l ö ̀ i ö k |
ajkö́nu̠ne̠	 a j k ö ́ n u ̠ n e ̠ |
sulû	 s u l û |
wámblër	 w á m b l ë r |
chö̀ulur	 c h ö ̀ u l u r |
dawö̀ulur	 d a w ö ̀ u l u r |
ñî̠köl	 ñ î ̠ k ö l |
i̠à̠rtse̠	 i ̠ à ̠ r t s e ̠ |
e'töm	 e ' t ö m |
ttö̀	 t t ö ̀ |
ie'rö	 i e ' r ö |
kuátkë	 k u á t k ë |
ulìta̠ne̠	 u l ì t a ̠ n e ̠ |
mì̠ne̠	 m ì ̠ n e ̠ |
kuátkök	 k u á t k ö k |
wa'ñe̠	 w a ' ñ e ̠ |
aì	 a ì |
chô	 c h ô |
wö̀wo̠	 w ö ̀ w o ̠ |
tsikírmi̠	 t s i k í r m i ̠ |
è̠ne̠wa̠mi̠	 è ̠ n e ̠ w a ̠ m i ̠ |
mì̠kalè	 m ì ̠ k a l è |
dè	 d è |
tsiríwe̠ke̠	 t s i r í w e ̠ k e ̠ |
tsiríwe̠	 t s i r í w e ̠ |
ké̠bata	 k é ̠ b a t a |
me̠'ie	 m e ̠ ' i e |
kiéka̠	 k i é k a ̠ |
kìne̠ka̠	 k ì n e ̠ k a ̠ |
kièka̠	 k i è k a ̠ |
à̠na̠wa̠	 à ̠ n a ̠ w a ̠ |
tsétse	 t s é t s e |
wámblö	 w á m b l ö |
kiàne̠	 k i à n e ̠ |
kë́sik	 k ë ́ s i k |
balö̀mi̠ne̠	 b a l ö ̀ m i ̠ n e ̠ |
ujtèmi̠	 u j t è m i ̠ |
wö́kir	 w ö ́ k i r |
dalë́wè̠	 d a l ë ́ w è ̠ |
kirìwe̠wa̠	 k i r ì w e ̠ w a ̠ |
kiár	 k i á r |
ká̠wö	 k á ̠ w ö |
mé̠rmi̠	 m é ̠ r m i ̠ |
da'	 d a ' |
kú̠nu̠k	 k ú ̠ n u ̠ k |
ajkö́ne̠	 a j k ö ́ n e ̠ |
dö̀pa	 d ö ̀ p a |
ska	 s k a |
wake'	 w a k e ' |
à̠te̠tke	 à ̠ t e ̠ t k e |
itö̀	 i t ö ̀ |
es	 e s |
érë	 é r ë |
ka̠nè̠	 k a ̠ n è ̠ |
ka̠nè̠wè̠mi̠	 k a ̠ n è ̠ w è ̠ m i ̠ |
púchi	 p ú c h i |
tsikìnu̠k	 t s i k ì n u ̠ k |
sha̠lê̠lê̠	 s h a ̠ l ê ̠ l ê ̠ |
ë	 ë |
kicha	 k i c h a |
chö	 c h ö |
shà̠	 s h à ̠ |
báne̠t	 b á n e ̠ t |
cha̠mù̠la	 c h a ̠ m ù ̠ l a |
kuátkèmi̠	 k u á t k è m i ̠ |
kuátke	 k u á t k e |
wö̀batse	 w ö ̀ b a t s e |
ésela	 é s e l a |
tsikír	 t s i k í r |
mí̠tkene̠	 m í ̠ t k e n e ̠ |
mú̠	 m ú ̠ |
kuála	 k u á l a |
ka̠nè̠o̠rmi̠	 k a ̠ n è ̠ o ̠ r m i ̠ |
iku̠á̠ki̠	 i k u ̠ á ̠ k i ̠ |
sé̠râ	 s é ̠ r â |
a̠mù̠bli	 a ̠ m ù ̠ b l i |
coroma	 c o r o m a |
i̠à̠ne̠	 i ̠ à ̠ n e ̠ |
ma̠nè̠ne̠tsa̠	 m a ̠ n è ̠ n e ̠ t s a ̠ |
bribriwak	 b r i b r i w a k |
bikéitse̠	 b i k é i t s e ̠ |
a̠mè̠ne̠a̠t	 a ̠ m è ̠ n e ̠ a ̠ t |
a̠mè̠ne̠	 a ̠ m è ̠ n e ̠ |
ië̀ka̠	 i ë ̀ k a ̠ |
ku̠é̠i̠	 k u ̠ é ̠ i ̠ |
siempre	 s i e m p r e |
alè	 a l è |
rë	 r ë |
të̀	 t ë ̀ |
tu̠è̠	 t u ̠ è ̠ |
kuáble	 k u á b l e |
átu	 á t u |
ali'	 a l i ' |
apì	 a p ì |
sawák	 s a w á k |
wè̠	 w è ̠ |
ajkàyë'	 a j k à y ë ' |
ka̠nè̠ble	 k a ̠ n è ̠ b l e |
ala'rla	 a l a ' r l a |
tièra	 t i è r a |
êjkë	 ê j k ë |
ká̠ñi̠rke̠	 k á ̠ ñ i ̠ r k e ̠ |
ká̠tuírke̠	 k á ̠ t u í r k e ̠ |
kó̠	 k ó ̠ |
íjkë	 í j k ë |
ma̠lé̠pa	 m a ̠ l é ̠ p a |
wö̀blao̠'	 w ö ̀ b l a o ̠ ' |
ka̠nè̠blök	 k a ̠ n è ̠ b l ö k |
yulö́k	 y u l ö ́ k |
àk	 à k |
balèku̠	 b a l è k u ̠ |
balè	 b a l è |
sulûë	 s u l û ë |
ka̠nè̠bleke̠	 k a ̠ n è ̠ b l e k e ̠ |
ajkàche	 a j k à c h e |
yö̂mi̠	 y ö ̂ m i ̠ |
yö̀ne̠mi̠	 y ö ̀ n e ̠ m i ̠ |
varios	 v a r i o s |
wö́ulârke̠	 w ö ́ u l â r k e ̠ |
wö́ulâne̠	 w ö ́ u l â n e ̠ |
tsö́k	 t s ö ́ k |
erë	 e r ë |
wö̂ikèke̠	 w ö ̂ i k è k e ̠ |
wö́ulâo̠	 w ö ́ u l â o ̠ |
wö́ulâo̠mi̠	 w ö ́ u l â o ̠ m i ̠ |
é̠ma̠	 é ̠ m a ̠ |
raúl	 r a ú l |
méndez	 m é n d e z |
ujchè̠n	 u j c h è ̠ n |
à̠	 à ̠ |
bikéitsèke̠	 b i k é i t s è k e ̠ |
yàli	 y à l i |
apàke	 a p à k e |
alatsítsi	 a l a t s í t s i |
wö̂ikmi̠	 w ö ̂ i k m i ̠ |
alàtsítsi	 a l à t s í t s i |
wö̂ik	 w ö ̂ i k |
bitu̠	 b i t u ̠ |
wö̂ike	 w ö ̂ i k e |
wö̂ìna̠	 w ö ̂ ì n a ̠ |
tka'	 t k a ' |
tawàlia	 t a w à l i a |
ñé̠es	 ñ é ̠ e s |
kë́këpala	 k ë ́ k ë p a l a |
àlim	 à l i m |
pa	 p a |
kö̀chi	 k ö ̀ c h i |
krò	 k r ò |
bàka	 b à k a |
kabàiö	 k a b à i ö |
kalö̀	 k a l ö ̀ |
o̠'mi̠k	 o ̠ ' m i ̠ k |
kàlkö	 k à l k ö |
dóma̠le̠	 d ó m a ̠ l e ̠ |
ka̠nè̠wo̠	 k a ̠ n è ̠ w o ̠ |
ichö́kle	 i c h ö ́ k l e |
ró	 r ó |
shirë́kö	 s h i r ë ́ k ö |
klòkö	 k l ò k ö |
shu̠lé̠	 s h u ̠ l é ̠ |
sö̀kkö	 s ö ̀ k k ö |
dapáwe̠ma̠le̠	 d a p á w e ̠ m a ̠ l e ̠ |
páliu̠köl	 p á l i u ̠ k ö l |
aîkö	 a î k ö |
bitù̠ke̠ma̠le̠	 b i t ù ̠ k e ̠ m a ̠ l e ̠ |
tsè̠	 t s è ̠ |
bítkuak	 b í t k u a k |
bö́tkuak	 b ö ́ t k u a k |
tkë́yök	 t k ë ́ y ö k |
sìtla	 s ì t l a |
wö̂iko	 w ö ̂ i k o |
étkuak	 é t k u a k |
tkabë̀	 t k a b ë ̀ |
kuéwa̠	 k u é w a ̠ |
ie'par	 i e ' p a r |
tsî̠	 t s î ̠ |
âr	 â r |
apàkö	 a p à k ö |
bulù	 b u l ù |
tsítsipala	 t s í t s i p a l a |
talâr	 t a l â r |
pàtu	 p à t u |
pú̠	 p ú ̠ |
irö̀	 i r ö ̀ |
cómo	 c ó m o |
se	 s e |
llama	 l l a m a |
kayö́	 k a y ö ́ |
dùsi̠a̠	 d ù s i ̠ a ̠ |
pík	 p í k |
ku̠ka̠'	 k u ̠ k a ̠ ' |
wö́ni̠k	 w ö ́ n i ̠ k |
pulë̀	 p u l ë ̀ |
tsítsipa	 t s í t s i p a |
kalö'wo̠	 k a l ö ' w o ̠ |
shù̠	 s h ù ̠ |
mâ̠tkle	 m â ̠ t k l e |
apàto	 a p à t o |
na̠mù̠	 n a ̠ m ù ̠ |
akà	 a k à |
talók	 t a l ó k |
akàla	 a k à l a |
pà̠rlor	 p à ̠ r l o r |
wë́	 w ë ́ |
jueputa	 j u e p u t a |
si̠nà̠s	 s i ̠ n à ̠ s |
kö	 k ö |
vea	 v e a |
bakèla	 b a k è l a |
bakè	 b a k è |
bika'	 b i k a ' |
yë̀ñapala	 y ë ̀ ñ a p a l a |
pàtököl	 p à t ö k ö l |
wéblö	 w é b l ö |
tsè̠bitu̠	 t s è ̠ b i t u ̠ |
dalé	 d a l é |
ujtö́	 u j t ö ́ |
tsî̠ne̠t	 t s î ̠ n e ̠ t |
krá	 k r á |
wö́rki̠	 w ö ́ r k i ̠ |
kuë̀	 k u ë ̀ |
wì̠m	 w ì ̠ m |
wìm	 w ì m |
kachúk	 k a c h ú k |
alö̀buk	 a l ö ̀ b u k |
urrì	 u r r ì |
dakòlum	 d a k ò l u m |
stsí	 s t s í |
wàpie	 w à p i e |
ês	 ê s |
biké	 b i k é |
apàyo	 a p à y o |
wé̠s	 w é ̠ s |
batséi	 b a t s é i |
iki'wè̠ka̠	 i k i ' w è ̠ k a ̠ |
iska	 i s k a |
wé̠ma̠le̠	 w é ̠ m a ̠ l e ̠ |
tsé̠mi̠	 t s é ̠ m i ̠ |
tsule'	 t s u l e ' |
e'ta	 e ' t a |
shù̠aline̠	 s h ù ̠ a l i n e ̠ |
bikéitse	 b i k é i t s e |
batsé	 b a t s é |
bukulú	 b u k u l ú |
ña̠là̠	 ñ a ̠ l à ̠ |
tse̠ke̠	 t s e ̠ k e ̠ |
katúr	 k a t ú r |
klö́m	 k l ö ́ m |
klö́bli	 k l ö ́ b l i |
sé̠se̠	 s é ̠ s e ̠ |
sé̠se̠la	 s é ̠ s e ̠ l a |
yè	 y è |
kuáblök	 k u á b l ö k |
buë'	 b u ë ' |
kuá	 k u á |
wé̠alê	 w é ̠ a l ê |
el	 e l |
muchacho	 m u c h a c h o |
akë́chkeël	 a k ë ́ c h k e ë l |
êskapë	 ê s k a p ë |
tsîrlaël	 t s î r l a ë l |
stsa'wö	 s t s a ' w ö |
colegio	 c o l e g i o |
ka̠nè̠blö	 k a ̠ n è ̠ b l ö |
wö̀blane̠	 w ö ̀ b l a n e ̠ |
ñè̠	 ñ è ̠ |
ñè̠ke̠	 ñ è ̠ k e ̠ |
na̠i̠'chka	 n a ̠ i ̠ ' c h k a |
katàne̠	 k a t à n e ̠ |
à̠a̠	 à ̠ a ̠ |
na̠i̠'	 n a ̠ i ̠ ' |
ditsö̀wöpa	 d i t s ö ̀ w ö p a |
shtàwẽ̀mĩ	 s h t à w ẽ ̀ m ĩ |
sĩõ'tãmĩ	 s ĩ õ ' t ã m ĩ |
	  |
wẽ̀s	 w ẽ ̀ s |
yö̀rmĩ	 y ö ̀ r m ĩ |
kãnẽ̀ũk	 k ã n ẽ ̀ ũ k |
yö̀rke	 y ö ̀ r k e |
mĩ̀kã	 m ĩ ̀ k ã |
yö̀rkèmĩ	 y ö ̀ r k è m ĩ |
batséitsèke	 b a t s é i t s è k e |
kãnẽ̀wẽ̀ke	 k ã n ẽ ̀ w ẽ ̀ k e |
kõ̀s	 k õ ̀ s |
ẽ'	 ẽ ' |
yawö̀ke	 y a w ö ̀ k e |
cha	 c h a |
kṍwötã	 k õ ́ w ö t ã |
íñẽ	 í ñ ẽ |
ã	 ã |
yuwè	 y u w è |
ĩ́ẽ	 ĩ ́ ẽ |
tchë̀r	 t c h ë ̀ r |
mṹ	 m ũ ́ |
yuwök	 y u w ö k |
chèmĩ	 c h è m ĩ |
wẽ́	 w ẽ ́ |
wĩ́se	 w ĩ ́ s e |
yuwákle	 y u w á k l e |
kĩ	 k ĩ |
kiànẽ	 k i à n ẽ |
yö̀r	 y ö ̀ r |
íñe	 í ñ e |
chàkök	 c h à k ö k |
dàtsĩtche	 d à t s ĩ t c h e |
mĩ̀tche	 m ĩ ̀ t c h e |
éẽrö	 é ẽ r ö |
éẽ	 é ẽ |
klö̀wẽ̀ke	 k l ö ̀ w ẽ ̀ k e |
tsuru'	 t s u r u ' |
kuö̀k	 k u ö ̀ k |
bikàkla	 b i k à k l a |
dur	 d u r |
ès	 è s |
bikékla	 b i k é k l a |
dùrkĩ	 d ù r k ĩ |
kabë̀la	 k a b ë ̀ l a |
ñẽ́ẽ	 ñ ẽ ́ ẽ |
diö̀	 d i ö ̀ |
yèkètche	 y è k è t c h e |
shkö̀	 s h k ö ̀ |
tchër	 t c h ë r |
klö̀rke	 k l ö ̀ r k e |
mẽ̀ke	 m ẽ ̀ k e |
kkué	 k k u é |
tsṍwek	 t s õ ́ w e k |
tsṍ	 t s õ ́ |
ẽ̀rpa	 ẽ ̀ r p a |
abuelita	 a b u e l i t a |
aìse	 a ì s e |
dàtsẽ	 d à t s ẽ |
klö̀ũk	 k l ö ̀ ũ k |
klö̀wẽke	 k l ö ̀ w ẽ k e |
m	 m |
mã	 m ã |
wĩ̀ke	 w ĩ ̀ k e |
dkrò	 d k r ò |
kö̀yök	 k ö ̀ y ö k |
kë́kë	 k ë ́ k ë |
kö̀yànẽ	 k ö ̀ y à n ẽ |
iã	 i ã |
ulítãnẽ	 u l í t ã n ẽ |
sẽ́rãã	 s ẽ ́ r ã ã |
ah	 a h |
kuö̀wöla	 k u ö ̀ w ö l a |
wö̀k	 w ö ̀ k |
wẽ	 w ẽ |
́	 ́ |
mĩ̀ke	 m ĩ ̀ k e |
sĩõ'	 s ĩ õ ' |
e'la	 e ' l a |
tã	 t ã |
yuwö̀kbala	 y u w ö ̀ k b a l a |
s	 s |
klö̀wẽ	 k l ö ̀ w ẽ |
kuö̀	 k u ö ̀ |
mĩ̀r	 m ĩ ̀ r |
r	 r |
kĩ́ka	 k ĩ ́ k a |
klö̀nẽ	 k l ö ̀ n ẽ |
dékã	 d é k ã |
tchétökicha	 t c h é t ö k i c h a |
e'tã	 e ' t ã |
lònẽ	 l ò n ẽ |
"	 " |
dö̀kã	 d ö ̀ k ã |
ñẽ'	 ñ ẽ ' |
mĩr	 m ĩ r |
wẽ̀ke	 w ẽ ̀ k e |
klö̀nẽ̀tche	 k l ö ̀ n ẽ ̀ t c h e |
kkuè	 k k u è |
õ̀ne	 õ ̀ n e |
bàwẽ̀ke	 b à w ẽ ̀ k e |
ulé	 u l é |
ulàklö̀ũ̀ke	 u l à k l ö ̀ ũ ̀ k e |
kúshki	 k ú s h k i |
ñãtchèke	 ñ ã t c h è k e |
ímã	 í m ã |
yuwèke	 y u w è k e |
bala	 b a l a |
i'tã	 i ' t ã |
tté	 t t é |
chök	 c h ö k |
""be'	 " " b e ' |
jkuö́""	 j k u ö ́ " " |
o	 o |
rpáũ""	 r p á ũ " " |
yulö́""	 y u l ö ́ " " |
surùrù	 s u r ù r ù |
yulèke	 y u l è k e |
ãã	 ã ã |
lèke	 l è k e |
chũmũ̀	 c h ũ m ũ ̀ |
wö̀tchèke	 w ö ̀ t c h è k e |
kö̀yèke	 k ö ̀ y è k e |
ttèke	 t t è k e |
kõ̀r	 k õ ̀ r |
sẽ́	 s ẽ ́ |
""íñẽ	 " " í ñ ẽ |
tsṍlĩ	 t s õ ́ l ĩ |
ñe'	 ñ e ' |
rpánẽ	 r p á n ẽ |
kõ̀re	 k õ ̀ r e |
rpánẽtche	 r p á n ẽ t c h e |
dà	 d à |
tulèkèwã	 t u l è k è w ã |
kerèè	 k e r è è |
kàltákla	 k à l t á k l a |
tãmĩ́	 t ã m ĩ ́ |
tchèkèwã	 t c h è k è w ã |
tãmĩ́pa	 t ã m ĩ ́ p a |
bátsike	 b á t s i k e |
timĩ́	 t i m ĩ ́ |
kë́chikè	 k ë ́ c h i k è |
mĩk	 m ĩ k |
kabë̀lala	 k a b ë ̀ l a l a |
kĩ́kã	 k ĩ ́ k ã |
ñẽ́jkë	 ñ ẽ ́ j k ë |
chakàla	 c h a k a ̀ l a |
élkela	 é l k e l a |
lìnẽ	 l ì n ẽ |
dikótö	 d i k ó t ö |
chö́k	 c h ö ́ k |
kö̀ppèkèkãtche	 k ö ̀ p p è k è k ã t c h e |
ñẽ́ẽrö	 ñ ẽ ́ ẽ r ö |
ñẽ̀kũ̀wã	 ñ ẽ ̀ k ũ ̀ w ã |
mẽ̀nẽ	 m ẽ ̀ n ẽ |
ñẽ̀wã	 ñ ẽ ̀ w ã |
ñẽ̀ke	 ñ ẽ ̀ k e |
ñẽ̀kewã	 ñ ẽ ̀ k e w ã |
wö̀mãnẽ̀rke	 w ö ̀ m ã n ẽ ̀ r k e |
wĩ́kĩ	 w ĩ ́ k ĩ |
ĩõ̀kĩ	 ĩ õ ̀ k ĩ |
èka	 è k a |
mẽ̀kènẽ	 m ẽ ̀ k è n ẽ |
tsṍkuèke	 t s õ ́ k u è k e |
tás	 t á s |
éwa	 é w a |
ñèke	 ñ è k e |
wĩ̀	 w ĩ ̀ |
tso'tche	 t s o ' t c h e |
tamĩ́	 t a m ĩ ́ |
kãnẽ́	 k ã n ẽ ́ |
mũlépa	 m ũ l é p a |
ñã̀nẽ	 ñ ã ̀ n ẽ |
ès	 e ̀ s |
kõ̀rë	 k õ ̀ r ë |
sũwẽ̀ke	 s ũ w ẽ ̀ k e |
yö̀rkela	 y ö ̀ r k e l a |
sũwẽ̀	 s ũ w ẽ ̀ |
rñẽ̀ẽ̀	 r ñ ẽ ̀ ẽ ̀ |
bulé	 b u l é |
wö̀të̀nẽ	 w ö ̀ t ë ̀ n ẽ |
ãñĩ̀es	 ã ñ ĩ ̀ e s |
bitsö̀ke	 b i t s ö ̀ k e |
ñĩ̀ĩ̀	 ñ ĩ ̀ ĩ ̀ |
bulàmĩ	 b u l à m ĩ |
shkènẽ	 s h k è n ẽ |
bità	 b i t à |
ñẽ̀kènẽ	 ñ ẽ ̀ k è n ẽ |
yèke	 y è k e |
pònẽ̀mĩ	 p ò n ẽ ̀ m ĩ |
mĩ̀chò	 m ĩ ̀ c h ò |
kãñĩ́k	 k ã ñ ĩ ́ k |
mĩ̀tsẽ	 m ĩ ̀ t s ẽ |
che	 c h e |
""tchẽ́k	 " " t c h ẽ ́ k |
rö̀nẽ	 r ö ̀ n ẽ |
íẽ	 í ẽ |
ã""	 ã " " |
wĩ́ẽ	 w ĩ ́ ẽ |
chòò	 c h ò ò |
ár	 á r |
tök	 t ö k |
ṹ	 ũ ́ |
ppṍ	 p p õ ́ |
rpö̀	 r p ö ̀ |
tchök	 t c h ö k |
tchö̀k	 t c h ö ̀ k |
rpáwẽ̀ke	 r p á w ẽ ̀ k e |
kapö̀ke	 k a p ö ̀ k e |
kapë̀ule	 k a p ë ̀ u l e |
shõ̀õ̀	 s h õ ̀ õ ̀ |
dö̀nẽ	 d ö ̀ n ẽ |
tchẽ́k	 t c h ẽ ́ k |
dàtsĩkènẽ	 d à t s ĩ k è n ẽ |
yö̀kĩkã	 y ö ̀ k ĩ k ã |
ãwĩ̀ẽ	 ã w ĩ ̀ ẽ |
wẽ́shkẽ	 w ẽ ́ s h k ẽ |
rpáũk	 r p á ũ k |
chãmũ̀	 c h ã m ũ ̀ |
jkuök	 j k u ö k |
dàtsikènẽ	 d à t s i k è n ẽ |
jkuö̀k	 j k u ö ̀ k |
yóie	 y ó i e |
chö́kale	 c h ö ́ k a l e |
ése;	 é s e ; |
jkuö̀k;	 j k u ö ̀ k ; |
yök	 y ö k |
bánẽt	 b á n ẽ t |
yàmĩpa	 y à m ĩ p a |
balèke	 b a l è k e |
èmã	 è m ã |
mĩ̀nã	 m ĩ ̀ n ã |
kutápa	 k u t á p a |
wĩ̀kela	 w ĩ ̀ k e l a |
yèse	 y è s e |
tso'se	 t s o ' s e |
mĩ̀	 m ĩ ̀ |
mĩ̀nẽ	 m ĩ ̀ n ẽ |
nẽ'	 n ẽ ' |
kujkuö̀k	 k u j k u ö ̀ k |
dénẽ	 d é n ẽ |
tsuru'la	 t s u r u ' l a |
jkué	 j k u é |
sũ̀	 s ũ ̀ |
wã	 w ã |
bitẽ́	 b i t ẽ ́ |
wĩ̀ẽ	 w ĩ ̀ ẽ |
tsṍkö̀rkètchenẽ	 t s õ ́ k ö ̀ r k è t c h e n ẽ |
éẽ;	 é ẽ ; |
pàsiwẽ̀ke	 p à s i w ẽ ̀ k e |
síule	 s í u l e |
kṍkö̀ie	 k õ ́ k ö ̀ i e |
árie	 á r i e |
dàtsike	 d à t s i k e |
èwa	 è w a |
tsṍkuèkènẽ	 t s õ ́ k u è k è n ẽ |
íke	 í k e |
ñẽ̀ẽ	 ñ ẽ ̀ ẽ |
débitũ	 d é b i t ũ |
su	 s u |
mĩ̀tchènẽ	 m ĩ ̀ t c h è n ẽ |
tsṍwẽ	 t s õ ́ w ẽ |
mĩ́	 m ĩ ́ |
tkótö	 t k ó t ö |
blo'la	 b l o ' l a |
blòblòla	 b l ò b l ò l a |
yèkènẽ	 y è k è n ẽ |
pë'	 p ë ' |
yànẽ	 y à n ẽ |
iál	 i á l |
sulùũke	 s u l ù ũ k e |
ẽ́n	 ẽ ́ n |
sũwẽ́	 s ũ w ẽ ́ |
õ̀nẽ	 õ ̀ n ẽ |
sulùõ̀wã	 s u l ù õ ̀ w ã |
èkapë	 e ̀ k a p ë |
mẽ́wẽ̀wã	 m ẽ ́ w ẽ ̀ w ã |
èkëpë	 è k ë p ë |
èkapë	 è k a p ë |
mẽ́nẽwã;	 m ẽ ́ n ẽ w ã ; |
kũẽ́kĩ	 k ũ ẽ ́ k ĩ |
chaké	 c h a k é |
mẽ̀nẽ̀ãt	 m ẽ ̀ n ẽ ̀ ã t |
yö̀ie	 y ö ̀ i e |
bàtan	 b à t a n |
yulèkètche	 y u l è k è t c h e |
yulök	 y u l ö k |
iö́k	 i ö ́ k |
dë̀	 d ë ̀ |
natalia	 n a t a l i a |
kièke	 k i è k e |
ñũ	 ñ ũ |
wĩ'	 w ĩ ' |
émã	 é m ã |
kë́chike	 k ë ́ c h i k e |
mĩ̀ke;	 m ĩ ̀ k e ; |
juwé	 j u w é |
mj	 m j |
tchë́l	 t c h ë ́ l |
sã́ũ	 s ã ́ ũ |
mĩ̀tchela	 m ĩ ̀ t c h e l a |
kué	 k u é |
katèke	 k a t è k e |
kùnẽ	 k ù n ẽ |
mĩ̀k	 m ĩ ̀ k |
juwá	 j u w á |
ẽh	 ẽ h |
juwápa	 j u w á p a |
yàrke	 y à r k e |
noo!	 n o o ! |
èklala	 è k l a l a |
yànũk	 y à n ũ k |
tã;	 t ã ; |
kũẽ́k	 k ũ ẽ ́ k |
yö̀rketche	 y ö ̀ r k e t c h e |
yuwö̀k	 y u w ö ̀ k |
yö̀nẽ	 y ö ̀ n ẽ |
èkalala	 è k a l a l a |
yé	 y é |
kuli'	 k u l i ' |
ië̀nẽ̀wã	 i ë ̀ n ẽ ̀ w ã |
iènẽ̀wã	 i è n ẽ ̀ w ã |
'õnõ̀s	 ' õ n õ ̀ s |
ièke	 i è k e |
ièkèwã	 i è k è w ã |
bitũ̀ke	 b i t ũ ̀ k e |
kũẽ́	 k ũ ẽ ́ |
iõ̀iõ̀	 i õ ̀ i õ ̀ |
dùla	 d ù l a |
tso'iã	 t s o ' i ã |
sũlĩ̀	 s ũ l ĩ ̀ |
kàsir	 k à s i r |
kõnõ'	 k õ n õ ' |
kũẽ̀iã	 k ũ ẽ ̀ i ã |
tö;	 t ö ; |
sh	 s h |
choò	 c h o ò |
chìchila	 c h ì c h i l a |
wö̀balawẽ́	 w ö ̀ b a l a w ẽ ́ |
yë́balök	 y ë ́ b a l ö k |
iálpa	 i á l p a |
yö̀kĩ	 y ö ̀ k ĩ |
anstasia	 a n s t a s i a |
démĩ	 d é m ĩ |
tö̀tchèkètche	 t ö ̀ t c h è k è t c h e |
tö̀tchök	 t ö ̀ t c h ö k |
tö̀tchök;	 t ö ̀ t c h ö k ; |
tö̀tchèke	 t ö ̀ t c h è k e |
kũẽ̀mĩ	 k ũ ẽ ̀ m ĩ |
kanẽ̀wẽ̀ke	 k a n ẽ ̀ w ẽ ̀ k e |
ñõ̀wẽ̀ke	 ñ õ ̀ w ẽ ̀ k e |
wẽ̀ke;	 w ẽ ̀ k e ; |
wö̀balaũ̀tche	 w ö ̀ b a l a ũ ̀ t c h e |
yë́syë̀së	 y ë ́ s y ë ̀ s ë |
mũ̀kètsã	 m ũ ̀ k è t s ã |
wö̀balaũ̀ke	 w ö ̀ b a l a ũ ̀ k e |
bitsö̀kkã	 b i t s ö ̀ k k ã |
alàla	 a l à l a |
kãnẽ̀wẽ̀ke;	 k ã n ẽ ̀ w ẽ ̀ k e ; |
mĩ̀ka	 m ĩ ̀ k a |
diö̀yàrke	 d i ö ̀ y à r k e |
ñĩ̀	 ñ ĩ ̀ |
diö̀yö̀ke	 d i ö ̀ y ö ̀ k e |
ñĩ̀we	 ñ ĩ ̀ w e |
tsṍwe	 t s õ ́ w e |
pàkètcha	 p à k è t c h a |
ñã̀nẽ;	 ñ ã ̀ n ẽ ; |
kṍmĩ	 k õ ́ m ĩ |
yö̀wã	 y ö ̀ w ã |
ñũ̀wã	 ñ ũ ̀ w ã |
õ̀rtã	 õ ̀ r t ã |
chö́k;	 c h ö ́ k ; |
dolò	 d o l ò |
ë̀mẽ	 ë ̀ m ẽ |
póppòë	 p ó p p ò ë |
yènẽ	 y è n ẽ |
kũ	 k ũ |
tsṍyànẽ	 t s õ ́ y à n ẽ |
ni	 n i |
chö́pa	 c h ö ́ p a |
kë́chikéla	 k ë ́ c h i k é l a |
kë́chiképàtche	 k ë ́ c h i k é p à t c h e |
yàrkètche	 y à r k è t c h e |
mĩ́la	 m ĩ ́ l a |
kák	 k á k |
yë̀nẽ	 y ë ̀ n ẽ |
wákpala	 w á k p a l a |
mẽ̀wẽ̀kewã;	 m ẽ ̀ w ẽ ̀ k e w ã ; |
chétcha	 c h é t c h a |
sulù	 s u l ù |
mẽ̀wẽ	 m ẽ ̀ w ẽ |
mẽ̀wẽ̀wã	 m ẽ ̀ w ẽ ̀ w ã |
ñĩ̀es	 ñ ĩ ̀ e s |
emã	 e m ã |
kapö̀k	 k a p ö ̀ k |
chò	 c h ò |
ñẽ'tã	 ñ ẽ ' t ã |
kũẽkĩ	 k ũ ẽ k ĩ |
ùla	 ù l a |
yuwö̀ke	 y u w ö ̀ k e |
tchër;	 t c h ë r ; |
wèla	 w è l a |
ètökicha	 è t ö k i c h a |
shkök	 s h k ö k |
kẽ́ũk	 k ẽ ́ ũ k |
kuö̀kĩ	 k u ö ̀ k ĩ |
tã́iã	 t ã ́ i ã |
bitsèbita	 b i t s è b i t a |
mĩ̀nẽã	 m ĩ ̀ n ẽ ã |
m'm	 m ' m |
èttsinĩ	 è t t s i n ĩ |
ñẽ́es	 ñ ẽ ́ e s |
kölö̀wẽ	 k ö l ö ̀ w ẽ |
í	 í |
dapárke	 d a p á r k e |
ulàwa	 u l à w a |
wĩ̀es;	 w ĩ ̀ e s ; |
ulàwa;	 u l à w a ; |
mm	 m m |
mẽlẽ̀ã	 m ẽ l ẽ ̀ ã |
pàkök	 p à k ö k |
rpárke	 r p á r k e |
bítökicha	 b í t ö k i c h a |
tsṍyèke	 t s õ ́ y è k e |
bö̀tökicha	 b ö ̀ t ö k i c h a |
tchë́tokicha	 t c h ë ́ t o k i c h a |
kãnẽ̀wèke	 k ã n ẽ ̀ w è k e |
kẽ́wek	 k ẽ ́ w e k |
mẽnẽ̀wẽ̀ke	 m ẽ n ẽ ̀ w ẽ ̀ k e |
un	 u n |
poco	 p o c o |
kãnẽ̀wẽ	 k ã n ẽ ̀ w ẽ |
mĩchòë	 m ĩ c h ò ë |
kẽ́krà	 k ẽ ́ k r à |
dàtsikène	 d à t s i k è n e |
ri	 r i |
mĩ̀nẽ̀nẽ	 m ĩ ̀ n ẽ ̀ n ẽ |
a	 a |
tsṍtcha	 t s õ ́ t c h a |
sũ̀ë	 s ũ ̀ ë |
sĩõ'tãmĩpa	 s ĩ õ ' t ã m ĩ p a |
i'se	 i ' s e |
bitsé	 b i t s é |
darë̀rë̀	 d a r ë ̀ r ë ̀ |
tsé	 t s é |
bitàla	 b i t à l a |
yàrkenẽ	 y à r k e n ẽ |
kók	 k ó k |
pàkuèkenẽ	 p à k u è k e n ẽ |
aí	 a í |
kũẽ̀kèkã	 k ũ ẽ ̀ k è k ã |
wẽ̀	 w ẽ ̀ |
pàkuèke	 p à k u è k e |
shõ̀	 s h õ ̀ |
yë̀nũkã	 y ë ̀ n ũ k ã |
ichàkíule	 i c h à k í u l e |
ishtàwẽ̀mĩ	 i s h t à w ẽ ̀ m ĩ |
sobre	 s o b r e |
kãnẽ̀balö	 k ã n ẽ ̀ b a l ö |
mami	 m a m i |
ishtàwẽ́	 i s h t à w ẽ ́ |
tsë̀ë	 t s ë ̀ ë |
ãjã́	 ã j ã ́ |
ẽẽ	 ẽ ẽ |
wẽlè	 w ẽ l è |
yönẽ	 y ö n ẽ |
kibìie	 k i b ì i e |
ditséwöpa	 d i t s é w ö p a |
shũ̀shã̀	 s h ũ ̀ s h ã ̀ |
ie;	 i e ; |
dë́l	 d ë ́ l |
yë̀bitũ	 y ë ̀ b i t ũ |
mãnẽ̀te	 m ã n ẽ ̀ t e |
kuö̀wö	 k u ö ̀ w ö |
rö̀pakã	 r ö ̀ p a k ã |
kìnẽ	 k ì n ẽ |
káũk	 k á ũ k |
iõiõ̀	 i õ i õ ̀ |
tã́ĩ;	 t ã ́ ĩ ; |
kö̀iè	 k ö ̀ i è |
ar	 a r |
klö̀tsã	 k l ö ̀ t s ã |
dàtsĩ	 d à t s ĩ |
káwẽ́tsã	 k á w ẽ ́ t s ã |
mẽlẽ̀	 m ẽ l ẽ ̀ |
sũwõ'	 s ũ w õ ' |
suwõ'	 s u w õ ' |
kiètã́nẽ	 k i è t ã ́ n ẽ |
yö̀rtã	 y ö ̀ r t ã |
bua'ëmẽ	 b u a ' ë m ẽ |
mũ'	 m ũ ' |
ònẽ	 ò n ẽ |
ditsö̀pa	 d i t s ö ̀ p a |
bitsö̀rö	 b i t s ö ̀ r ö |
dö	 d ö |
lèkã	 l è k ã |
bua'ie	 b u a ' i e |
di	 d i |
dö̀ka	 d ö ̀ k a |
páiki	 p á i k i |
pedro	 p e d r o |
kṍjkẽ̀ẽ	 k õ ́ j k ẽ ̀ ẽ |
yuwák	 y u w á k |
suwànẽ	 s u w à n ẽ |
si	 s i |
yö̀rpa	 y ö ̀ r p a |
yö̀nṍk	 y ö ̀ n õ ́ k |
mĩ́ã	 m ĩ ́ ã |
sa	 s a |
kë́köl	 k ë ́ k ö l |
dö̀mĩ	 d ö ̀ m ĩ |
wéìnẽ	 w é ì n ẽ |
kacha'	 k a c h a ' |
tsũkmĩ	 t s ũ k m ĩ |
kkãmã'	 k k ã m ã ' |
wíbulu	 w í b u l u |
ulíulí	 u l í u l í |
shinõ̀nõ̀	 s h i n õ ̀ n õ ̀ |
tchërala	 t c h ë r a l a |
démĩpa	 d é m ĩ p a |
sklèla	 s k l è l a |
kö́ö	 k ö ́ ö |
""i	 " " i |
katànṍkwã""	 k a t à n õ ́ k w ã " " |
""se'	 " " s e ' |
katànõkwã""	 k a t à n õ k w ã " " |
añĩ̀	 a ñ ĩ ̀ |
dëlë̀r	 d ë l ë ̀ r |
tã́ĩ	 t ã ́ ĩ |
wö̀tö̀ke	 w ö ̀ t ö ̀ k e |
wö̀tö	 w ö ̀ t ö |
ièkã	 i è k ã |
caja	 c a j a |
tsṹmĩ	 t s ũ ́ m ĩ |
wö̀tö́wã	 w ö ̀ t ö ́ w ã |
dikó	 d i k ó |
bikèke	 b i k è k e |
ttö̀ke	 t t ö ̀ k e |
bikö̀ke	 b i k ö ̀ k e |
bikákla	 b i k á k l a |
nãmã̀bita	 n ã m ã ̀ b i t a |
bikö̀mĩ	 b i k ö ̀ m ĩ |
nãñẽ̀e	 n ã ñ ẽ ̀ e |
kã́ñĩ̀nẽ	 k ã ́ ñ ĩ ̀ n ẽ |
mĩ́tchèrak	 m ĩ ́ t c h è r a k |
wẽ́shkètche	 w ẽ ́ s h k è t c h e |
kièrak	 k i è r a k |
""wẽ́shkètche""	 " " w ẽ ́ s h k è t c h e " " |
batörö̀	 b a t ö r ö ̀ |
iõiõ̀ë	 i õ i õ ̀ ë |
mũlũ̀sik	 m ũ l ũ ̀ s i k |
éyök	 é y ö k |
tsa'	 t s a ' |
ták	 t á k |
mẽ̀kã	 m ẽ ̀ k ã |
suítö	 s u í t ö |
suíyö	 s u í y ö |
buèke	 b u è k e |
batsĩ̀	 b a t s ĩ ̀ |
rak	 r a k |
""suítö""	 " " s u í t ö " " |
imã	 i m ã |
nãmã̀bitala	 n ã m ã ̀ b i t a l a |
suí	 s u í |
yàrketche	 y à r k e t c h e |
kulé	 k u l é |
mẽ̀wã	 m ẽ ̀ w ã |
wö̀nĩka	 w ö ̀ n ĩ k a |
ĩ́shẽla	 ĩ ́ s h ẽ l a |
õ̀mĩk	 õ ̀ m ĩ k |
diö́shẽt	 d i ö ́ s h ẽ t |
tchèwã	 t c h è w ã |
aìshẽt	 a ì s h ẽ t |
èköl	 è k ö l |
shũshõ̀	 s h ũ s h õ ̀ |
tchèsẽ	 t c h è s ẽ |
mũlũ̀	 m ũ l ũ ̀ |
tsurúi	 t s u r ú i |
dàtsikètche	 d à t s i k è t c h e |
mẽ̀	 m ẽ ̀ |
kula'	 k u l a ' |
wíñõk	 w í ñ õ k |
èt	 è t |
àtsĩ	 à t s ĩ |
wö̀mãnẽ̀wẽ̀nẽ	 w ö ̀ m ã n ẽ ̀ w ẽ ̀ n ẽ |
wö̀mãnẽ̀wẽ̀ke	 w ö ̀ m ã n ẽ ̀ w ẽ ̀ k e |
wì	 w ì |
àtsẽ	 à t s ẽ |
aìëkã	 a ì ë k ã |
aìẽ	 a ì ẽ |
tsã́	 t s ã ́ |
tékã	 t é k ã |
tsìr	 t s ì r |
bulùbulùë	 b u l ù b u l ù ë |
islẽ́mã	 i s l ẽ ́ m ã |
wö̀mãnẽ̀rkètche	 w ö ̀ m ã n ẽ ̀ r k è t c h e |
mĩkã	 m ĩ k ã |
kë́kölö	 k ë ́ k ö l ö |
katö́	 k a t ö ́ |
chakö́	 c h a k ö ́ |
chakè	 c h a k è |
ñã́	 ñ ã ́ |
otro	 o t r o |
wẽmbrö	 w ẽ m b r ö |
tulur	 t u l u r |
chakö̀	 c h a k ö ̀ |
chakö̀ke	 c h a k ö ̀ k e |
skuée	 s k u é e |
kuö́kĩ	 k u ö ́ k ĩ |
mĩ́tsẽ̀wã	 m ĩ ́ t s ẽ ̀ w ã |
wë́tsë	 w ë ́ t s ë |
mẽ̀mĩ́tsẽ	 m ẽ ̀ m ĩ ́ t s ẽ |
shuwèkèwã	 s h u w è k è w ã |
mẽ̀kèwã	 m ẽ ̀ k è w ã |
ĩ́skĩ	 ĩ ́ s k ĩ |
klö̀ũkwã	 k l ö ̀ ũ k w ã |
klö̀wẽ̀wã	 k l ö ̀ w ẽ ̀ w ã |
íẽrö	 í ẽ r ö |
kö́kã""	 k ö ́ k ã " " |
íes	 í e s |
kö́kã	 k ö ́ k ã |
mṹwã	 m ũ ́ w ã |
diàë́ka	 d i à ë ́ k a |
mẽ́wã	 m ẽ ́ w ã |
suíyök	 s u í y ö k |
rrátkèwãtche	 r r á t k è w ã t c h e |
õ'	 õ ' |
mũẽ̀kèwã	 m ũ ẽ ̀ k è w ã |
sirö̀tak	 s i r ö ̀ t a k |
kàlkicha'	 k à l k i c h a ' |
tsa'kicha'	 t s a ' k i c h a ' |
wíbulula	 w í b u l u l a |
mĩchò	 m ĩ c h ò |
diö́köl	 d i ö ́ k ö l |
tabè	 t a b è |
mẽ̀nẽ̀wa	 m ẽ ̀ n ẽ ̀ w a |
tö̀kĩ	 t ö ̀ k ĩ |
kö́iéulewã	 k ö ́ i é u l e w ã |
kaléũ̀	 k a l é ũ ̀ |
bë́rbëla	 b ë ́ r b ë l a |
kalétsã	 k a l é t s ã |
aísũ	 a í s ũ |
chèkã	 c h è k ã |
kë́chike""	 k ë ́ c h i k e " " |
bitsi'	 b i t s i ' |
kö̀ppée	 k ö ̀ p p é e |
shõ̀ë̀mẽ	 s h õ ̀ ë ̀ m ẽ |
swĩ̀mĩ	 s w ĩ ̀ m ĩ |
kë̀wë̀kala	 k ë ̀ w ë ̀ k a l a |
mẽ́kã	 m ẽ ́ k ã |
tuèke	 t u è k e |
tã́ĩë	 t ã ́ ĩ ë |
kã́wötã	 k ã ́ w ö t ã |
bë̀rëmẽ	 b ë ̀ r ë m ẽ |
yö̀tsã	 y ö ̀ t s ã |
yë́tsã	 y ë ́ t s ã |
kañĩ́kã	 k a ñ ĩ ́ k ã |
iànẽ	 i à n ẽ |
mũẽ̀	 m ũ ẽ ̀ |
batũrèwã	 b a t ũ r è w ã |
tchátche	 t c h á t c h e |
bë̀rë	 b ë ̀ r ë |
ñãlã̀	 ñ ã l ã ̀ |
jkö̀	 j k ö ̀ |
tchörö	 t c h ö r ö |
mẽ̀rkèkã	 m ẽ ̀ r k è k ã |
katà	 k a t à |
balë̀rkètche	 b a l ë ̀ r k è t c h e |
skèkèwã	 s k è k è w ã |
mẽ̀kèiã̀nẽ	 m ẽ ̀ k è i ã ̀ n ẽ |
otra	 o t r a |
wàbale	 w à b a l e |
dë̀dë	 d ë ̀ d ë |
wĩ́ẽrö	 w ĩ ́ ẽ r ö |
baterèwãmĩ	 b a t e r è w ã m ĩ |
dínẽiã	 d í n ẽ i ã |
ulàmẽ̀ule	 u l à m ẽ ̀ u l e |
shkẽ̀rkèkãnẽ	 s h k ẽ ̀ r k è k ã n ẽ |
dalë̀r	 d a l ë ̀ r |
kãnẽ̀wẽ̀ketsã	 k ã n ẽ ̀ w ẽ ̀ k e t s ã |
ã̀s	 ã ̀ s |
ókömpa	 ó k ö m p a |
kë́chikepa	 k ë ́ c h i k e p a |
wĩ́ẽrö;	 w ĩ ́ ẽ r ö ; |
mũk	 m ũ k |
iö̀kwã	 i ö ̀ k w ã |
törö̀kwã	 t ö r ö ̀ k w ã |
teréwã	 t e r é w ã |
balök	 b a l ö k |
ishkẽ̀rkèkã	 i s h k ẽ ̀ r k è k ã |
mẽ́ule	 m ẽ ́ u l e |
iõ̀	 i õ ̀ |
alàralar	 a l à r a l a r |
yö̀nẽbitũ	 y ö ̀ n ẽ b i t ũ |
yu	 y u |
bité	 b i t é |
teré	 t e r é |
wötö́kwã	 w ö t ö ́ k w ã |
ĩ́yök	 ĩ ́ y ö k |
kã́jkẽ	 k ã ́ j k ẽ |
balö̀rö	 b a l ö ̀ r ö |
kã'	 k ã ' |
tèke	 t è k e |
mẽr	 m ẽ r |
kuè	 k u è |
õ̀mĩkã	 õ ̀ m ĩ k ã |
kuèkèwã	 k u è k è w ã |
wanẽ	 w a n ẽ |
tchéwã	 t c h é w ã |
wö̀stéwã	 w ö ̀ s t é w ã |
tká	 t k á |
mĩchö̀ë	 m ĩ c h ö ̀ ë |
ukuö̀k	 u k u ö ̀ k |
ukuè	 u k u è |
kö̀nẽ	 k ö ̀ n ẽ |
skìnẽ	 s k ì n ẽ |
kàlka	 k à l k a |
wö̀nẽ́	 w ö ̀ n ẽ ́ |
tsã̀	 t s ã ̀ |
biökè	 b i ö k è |
kànẽ	 k à n ẽ |
bë́rbër	 b ë ́ r b ë r |
rñẽ́we	 r ñ ẽ ́ w e |
kṍ	 k õ ́ |
ukuö́ũk	 u k u ö ́ ũ k |
wĩ́	 w ĩ ́ |
mĩ̀kèwã	 m ĩ ̀ k è w ã |
kã́	 k ã ́ |
shũshõ̀ë	 s h ũ s h õ ̀ ë |
bö'wö	 b ö ' w ö |
énũĩ̀	 é n ũ ĩ ̀ |
yë́wöla	 y ë ́ w ö l a |
por	 p o r |
eso	 e s o |
ë́l	 ë ́ l |
kuàt	 k u à t |
tché	 t c h é |
lista	 l i s t a |
shũshõ̀la	 s h ũ s h õ ̀ l a |
pákètche	 p á k è t c h e |
mĩ́tche	 m ĩ ́ t c h e |
ukuö́k	 u k u ö ́ k |
làri	 l à r i |
rpànẽ	 r p à n ẽ |
skuè	 s k u è |
ẽ̀nẽ̀wã	 ẽ ̀ n ẽ ̀ w ã |
ã;	 ã ; |
ba	 b a |
bánẽ	 b á n ẽ |
nãñẽ́we	 n ã ñ ẽ ́ w e |
tërkènẽ	 t ë r k è n ẽ |
kapö̀kwã	 k a p ö ̀ k w ã |
tchë́nĩk	 t c h ë ́ n ĩ k |
tchabàtchabàëmẽ	 t c h a b à t c h a b à ë m ẽ |
tsṍli	 t s õ ́ l i |
íe	 í e |
mũẽ̀wã	 m ũ ẽ ̀ w ã |
étchö	 é t c h ö |
ppéũ	 p p é ũ |
chip	 c h i p |
akuö̀k	 a k u ö ̀ k |
wö̀yètse	 w ö ̀ y è t s e |
bulámĩ	 b u l á m ĩ |
akuök	 a k u ö k |
di'bitàã	 d i ' b i t à ã |
tsã́lĩ	 t s ã ́ l ĩ |
akuö̀wẽ̀kenẽ	 a k u ö ̀ w ẽ ̀ k e n ẽ |
bö́iki	 b ö ́ i k i |
mĩtche	 m ĩ t c h e |
mũlũ̀nẽ	 m ũ l ũ ̀ n ẽ |
bë̀rbë̀rala	 b ë ̀ r b ë ̀ r a l a |
wö̀tsée	 w ö ̀ t s é e |
yétsã	 y é t s ã |
nĩẽ́ẽ	 n ĩ ẽ ́ ẽ |
biè	 b i è |
péũ	 p é ũ |
ñẽ̀	 ñ ẽ ̀ |
kèmĩ	 k è m ĩ |
chakö̀mĩ	 c h a k ö ̀ m ĩ |
pẽ́kèwã	 p ẽ ́ k è w ã |
wö̀pẽ́	 w ö ̀ p ẽ ́ |
dulë́dulë	 d u l ë ́ d u l ë |
kuèke	 k u è k e |
bë̀r	 b ë ̀ r |
pòjpò	 p ò j p ò |
õ̀nẽ̀wã	 õ ̀ n ẽ ̀ w ã |
terèwã	 t e r è w ã |
terèkèwã	 t e r è k è w ã |
lbòla	 l b ò l a |
pàterèwãmĩ	 p à t e r è w ã m ĩ |
wa'	 w a ' |
amũ	 a m ũ |
wákapa	 w á k a p a |
bitsö̀	 b i t s ö ̀ |
tã́ĩëmẽ	 t ã ́ ĩ ë m ẽ |
shũ̀	 s h ũ ̀ |
dalë̀rke	 d a l ë ̀ r k e |
sulìsulìla	 s u l ì s u l ì l a |
mmm	 m m m |
ũ̀	 ũ ̀ |
ë̀ka	 ë ̀ k a |
kibì	 k i b ì |
m'm'	 m ' m ' |
aunque	 a u n q u e |
duwö̀mĩ	 d u w ö ̀ m ĩ |
siõ̀rë	 s i õ ̀ r ë |
dalë̀rwã	 d a l ë ̀ r w ã |
ñẽ́rö	 ñ ẽ ́ r ö |
lbó	 l b ó |
yö̀ke	 y ö ̀ k e |
síki	 s í k i |
tchá	 t c h á |
bitséitsè	 b i t s é i t s è |
mĩ́chö̀	 m ĩ ́ c h ö ̀ |
bitsétchö	 b i t s é t c h ö |
páké	 p á k é |
tchátsã	 t c h á t s ã |
ajkuö̀	 a j k u ö ̀ |
klö̀r	 k l ö ̀ r |
klö̀r;	 k l ö ̀ r ; |
ajkuö̀mĩ́tsẽ	 a j k u ö ̀ m ĩ ́ t s ẽ |
pàkö̀rke	 p à k ö ̀ r k e |
pàkuö̀kñã	 p à k u ö ̀ k ñ ã |
wéikèkètche	 w é i k è k è t c h e |
b	 b |
wéikè	 w é i k è |
iö̀kã	 i ö ̀ k ã |
""b	 " " b |
wéikeráwã	 w é i k e r á w ã |
siõ̀dala""	 s i õ ̀ d a l a " " |
wẽ́jkë	 w ẽ ́ j k ë |
siõ̀dala	 s i õ ̀ d a l a |
kũ̀nẽiã""	 k ũ ̀ n ẽ i ã " " |
ñẽ	 ñ ẽ |
kẽ́	 k ẽ ́ |
ñĩ̀ṹknẽ	 ñ ĩ ̀ ũ ́ k n ẽ |
""ẽ'	 " " ẽ ' |
ñĩ̀ṹknẽ""	 ñ ĩ ̀ ũ ́ k n ẽ " " |
pàkuö̀knẽ	 p à k u ö ̀ k n ẽ |
kãñĩ́kã	 k ã ñ ĩ ́ k ã |
wẽ́rö	 w ẽ ́ r ö |
durnẽ	 d u r n ẽ |
kö̀nã̀rpa	 k ö ̀ n ã ̀ r p a |
rà	 r à |
kuö̀mĩ̀nẽ	 k u ö ̀ m ĩ ̀ n ẽ |
pàkö̀nãrmĩ	 p à k ö ̀ n ã r m ĩ |
réwã	 r é w ã |
butùbutùë	 b u t ù b u t ù ë |
kö̀nã̀nẽwã	 k ö ̀ n ã ̀ n ẽ w ã |
kabë̀lapa	 k a b ë ̀ l a p a |
sĩõ̀rë	 s ĩ õ ̀ r ë |
rwö̀	 r w ö ̀ |
tẽr	 t ẽ r |
""kabë̀la	 " " k a b ë ̀ l a |
kṍchök	 k õ ́ c h ö k |
tã""	 t ã " " |
tsìrë	 t s ì r ë |
kuö̀ráã	 k u ö ̀ r á ã |
shkẽ̀rpàkã	 s h k ẽ ̀ r p a ̀ k ã |
mĩ́kã	 m ĩ ́ k ã |
tsö́	 t s ö ́ |
nṹnũ	 n ũ ́ n ũ |
""sítala	 " " s í t a l a |
kobòtala""	 k o b ò t a l a " " |
kö̀rmĩtsẽ	 k ö ̀ r m ĩ t s ẽ |
kö̀rke	 k ö ̀ r k e |
ie'la	 i e ' l a |
ẽ́rdiàrtã	 ẽ ́ r d i à r t ã |
wẽ́ikë	 w ẽ ́ i k ë |
ékapë	 é k a p ë |
""chu	 " " c h u |
kuö́ũ	 k u ö ́ ũ |
ë̀mẽ""	 ë ̀ m ẽ " " |
""tsuru'	 " " t s u r u ' |
klö̀ṹ	 k l ö ̀ ũ ́ |
ñã	 ñ ã |
pàchö̀	 p à c h ö ̀ |
kàlwák	 k à l w á k |
chẽ̀r	 c h ẽ ̀ r |
ã•	 ã • |
tsë̀r	 t s ë ̀ r |
bua'ëtche	 b u a ' ë t c h e |
bitsè	 b i t s è |
kölö́m	 k ö l ö ́ m |
ñẽ̀kũ	 ñ ẽ ̀ k ũ |
ulìtẽnẽ	 u l ì t ẽ n ẽ |
bitsö̀keiã	 b i t s ö ̀ k e i ã |
tchö̀kã	 t c h ö ̀ k ã |
wö̀chika	 w ö ̀ c h i k a |
kàlkuö	 k à l k u ö |
tchékã	 t c h é k ã |
kékã	 k é k ã |
sĩõ̀dala	 s ĩ õ ̀ d a l a |
kĩ́jkẽ	 k ĩ ́ j k ẽ |
ré	 r é |
kë́buklupa	 k ë ́ b u k l u p a |
kièrö	 k i è r ö |
""talàwak""	 " " t a l à w a k " " |
talàwak	 t a l à w a k |
talà	 t a l à |
akë́köl	 a k ë ́ k ö l |
mẽ̀nĩ	 m ẽ ̀ n ĩ |
sulé	 s u l é |
kṍska	 k õ ́ s k a |
diã̀ërö	 d i ã ̀ ë r ö |
rö̀pàkã	 r ö ̀ p a ̀ k ã |
kàchök	 k à c h ö k |
sṹ	 s ũ ́ |
""idèala""	 " " i d è a l a " " |
pàtcháka	 p à t c h á k a |
sũ̀nṍkie	 s ũ ̀ n õ ́ k i e |
pàkë	 p à k ë |
mẽnẽ́t	 m ẽ n ẽ ́ t |
wàbalè	 w à b a l è |
diàẽrö	 d i à ẽ r ö |
wàbalë'	 w à b a l ë ' |
dùwã	 d ù w ã |
nũ̀	 n ũ ̀ |
balë'	 b a l ë ' |
kalö̀õ'	 k a l ö ̀ õ ' |
wẽ̀jkë	 w ẽ ̀ j k ë |
pàtchékã	 p à t c h é k ã |
kũ̀nẽ	 k ũ ̀ n ẽ |
yuwö̀ráã	 y u w ö ̀ r á ã |
rö̀pàkã	 r ö ̀ p à k ã |
idèala	 i d è a l a |
sũ̀nṍk	 s ũ ̀ n õ ́ k |
""sã́ũ	 " " s ã ́ ũ |
durkã""	 d u r k ã " " |
deṹtũ	 d e ũ ́ t ũ |
chiroles	 c h i r o l e s |
tsirìwẽ	 t s i r ì w ẽ |
sẽ́es	 s ẽ ́ e s |
ñẽ̀mĩ	 ñ ẽ ̀ m ĩ |
wéìkö̀ke	 w é ì k ö ̀ k e |
bitsèke	 b i t s è k e |
ahhh	 a h h h |
ujkuèke	 u j k u è k e |
dë̀wã	 d ë ̀ w ã |
ó	 ó |
bitséitsèke	 b i t s é i t s è k e |
ocho	 o c h o |
días	 d í a s |
kàlwö	 k à l w ö |
falta	 f a l t a |
tse	 t s e |
seis	 s e i s |
año	 a ñ o |
kukuö̀ñã	 k u k u ö ̀ ñ ã |
tóto	 t ó t o |
wö́ki	 w ö ́ k i |
diez	 d i e z |
ẽ́r	 ẽ ́ r |
bulùbulùpa	 b u l ù b u l ù p a |
röawá	 r ö a w á |
kalö̀wẽ	 k a l ö ̀ w ẽ |
làrlàrpa	 l à r l à r p a |
èse	 è s e |
iũ̀te	 i ũ ̀ t e |
chénẽ	 c h é n ẽ |
chàkè	 c h à k è |
dónẽ	 d ó n ẽ |
lònẽ;	 l ò n ẽ ; |
papá	 p a p á |
nṹ	 n ũ ́ |
más	 m á s |
seguro	 s e g u r o |
yë́syë̀se	 y ë ́ s y ë ̀ s e |
awápa	 a w á p a |
tãiã;	 t ã i ã ; |
talamanca	 t a l a m a n c a |
iẽ	 i ẽ |
ulìtãnẽ	 u l ì t ã n ẽ |
aja	 a j a |
nãñẽ̀we	 n ã ñ ẽ ̀ w e |
jĩñẽ́itsök	 j ĩ ñ ẽ ́ i t s ö k |
ínẽ	 í n ẽ |
alàr	 a l à r |
lè	 l è |
dóã	 d ó ã |
ttö́dàã	 t t ö ́ d à ã |
brö̀	 b r ö ̀ |
yo	 y o |
sé	 s é |
yö̀nẽ!	 y ö ̀ n ẽ ! |
ja	 j a |
ja…)	 j a … ) |
narciso	 n a r c i s o |
mo	 m o |
morales	 m o r a l e s |
kachìi	 k a c h ì i |
tö̀	 t ö ̀ |
kãnẽ̀balötke	 k ã n ẽ ̀ b a l ö t k e |
duwa'	 d u w a ' |
détsẽ	 d é t s ẽ |
íẽka	 í ẽ k a |
kũẽ́wã	 k ũ ẽ ́ w ã |
lolo	 l o l o |
guabito;	 g u a b i t o ; |
chàke	 c h à k e |
kálök	 k á l ö k |
sulùnẽ̀kã	 s u l ù n ẽ ̀ k ã |
ñẽ'ẽ'	 ñ ẽ ' ẽ ' |
wö̀blaũk	 w ö ̀ b l a ũ k |
ñĩ̀jkë́ë	 ñ ĩ ̀ j k ë ́ ë |
wakè	 w a k è |
kö́nẽ̀ke	 k ö ́ n ẽ ̀ k e |
yö̀rpaiã	 y ö ̀ r p a i ã |
yö̀rmĩĩã	 y ö ̀ r m ĩ ĩ ã |
cara	 c a r a |
i'dë	 i ' d ë |
yö̀nẽĩã	 y ö ̀ n ẽ ĩ ã |
chö̀k	 c h ö ̀ k |
shkál	 s h k á l |
de	 d e |
mayor	 m a y o r |
tãiã	 t ã i ã |
nã́ũyö	 n ã ́ ũ y ö |
dë̀bitũ	 d ë ̀ b i t ũ |
dë̀tsẽ	 d ë ̀ t s ẽ |
tiene	 t i e n e |
cinco	 c i n c o |
años	 a ñ o s |
diàẽ	 d i à ẽ |
uloyo	 u l o y o |
dawö̀chkela	 d a w ö ̀ c h k e l a |
tṹsula	 t ũ ́ s u l a |
dawö̀chke	 d a w ö ̀ c h k e |
narberto	 n a r b e r t o |
dë́ũtu	 d ë ́ ũ t u |
chörà	 c h ö r à |
diö́ẽ	 d i ö ́ ẽ |
chöràla	 c h ö r à l a |
õ̀tẽ	 õ ̀ t ẽ |
shṍböts	 s h õ ́ b ö t s |
mõ̀rmĩ̀nẽ	 m õ ̀ r m ĩ ̀ n ẽ |
dursẽ	 d u r s ẽ |
cuatro	 c u a t r o |
kë́képa	 k ë ́ k é p a |
yuwö̀	 y u w ö ̀ |
iõ̀ka	 i õ ̀ k a |
chakìkã	 c h a k ì k ã |
e'tã;	 e ' t ã ; |
kö̀ök	 k ö ̀ ö k |
sulùsi	 s u l ù s i |
usáwõk	 u s á w õ k |
alàrke	 a l à r k e |
tsök	 t s ö k |
tsèke	 t s è k e |
bikéitsök	 b i k é i t s ö k |
bö́tökicha	 b ö ́ t ö k i c h a |
dalër	 d a l ë r |
kũiã	 k ũ i ã |
wẽ́se	 w ẽ ́ s e |
balo'	 b a l o ' |
kö̀öie	 k ö ̀ ö i e |
láköl	 l á k ö l |
kũṍkĩ	 k ũ õ ́ k ĩ |
bë̀remẽ	 b ë ̀ r e m ẽ |
kĩ́tsèkũ	 k ĩ ́ t s è k ũ |
ètch	 è t c h |
kë̀këpa	 k ë ̀ k ë p a |
mṍũk	 m õ ́ ũ k |
kukuö̀	 k u k u ö ̀ |
mĩ́ãnẽ	 m ĩ ́ ã n ẽ |
""ie'pa	 " " i e ' p a |
kö̀ö	 k ö ̀ ö |
ie'pa""	 i e ' p a " " |
chakì	 c h a k ì |
pàka	 p à k a |
wĩ́kka	 w ĩ ́ k k a |
""ñẽ'	 " " ñ ẽ ' |
mṍũk""	 m õ ́ ũ k " " |
irö́mĩyal	 i r ö ́ m ĩ y a l |
wĩ́es	 w ĩ ́ e s |
mj!	 m j ! |
pë'busi	 p ë ' b u s i |
bë̀riebulu	 b ë ̀ r i e b u l u |
wë́bi	 w ë ́ b i |
sabìr	 s a b ì r |
sulùëmẽ	 s u l ù ë m ẽ |
wèikö̀ke	 w è i k ö ̀ k e |
bikéitsèke	 b i k é i t s è k e |
islèmã	 i s l è m ã |
õ̀rmĩ	 õ ̀ r m ĩ |
bë̀rë;	 b ë ̀ r ë ; |
kùkùnẽ	 k ù k ù n ẽ |
kã́pàkök	 k ã ́ p à k ö k |
suwẽ̀	 s u w ẽ ̀ |
kĩ́tsök	 k ĩ ́ t s ö k |
ë̀k	 ë ̀ k |
chö́	 c h ö ́ |
""ñẽ́es	 " " ñ ẽ ́ e s |
tchërkã	 t c h ë r k ã |
ché""	 c h é " " |
duwè	 d u w è |
ese	 e s e |
kĩ́tsö́	 k ĩ ́ t s ö ́ |
lànẽ	 l à n ẽ |
énũĩ	 é n ũ ĩ |
aahh	 a a h h |
páùtke	 p á ù t k e |
duwás	 d u w á s |
diö̀yànẽ	 d i ö ̀ y à n ẽ |
sku'	 s k u ' |
yawök	 y a w ö k |
ètcha	 è t c h a |
tsìdalala	 t s ì d a l a l a |
ákwö	 á k w ö |
iówã	 i ó w ã |
kichà	 k i c h à |
tsìdala	 t s ì d a l a |
ièka	 i è k a |
tã́nkle	 t ã ́ n k l e |
tsã́tèwã	 t s ã ́ t è w ã |
tsã́te	 t s ã ́ t e |
está	 e s t á |
dalèwã	 d a l è w ã |
íkke	 í k k e |
ya'	 y a ' |
kañĩ́k	 k a ñ ĩ ́ k |
sùnẽ	 s ù n ẽ |
dö̀wãmĩ	 d ö ̀ w ã m ĩ |
dö̀tã	 d ö ̀ t ã |
momento	 m o m e n t o |
tchõ'	 t c h õ ' |
""ísã	 " " í s ã |
kapi""	 k a p i " " |
kapi	 k a p i |
dikóchka	 d i k ó c h k a |
ilèe	 i l è e |
iõ̀kĩ	 i õ ̀ k ĩ |
tchã'	 t c h ã ' |
chö́wẽ̀kèwã	 c h ö ́ w ẽ ̀ k è w ã |
kabènẽ	 k a b è n ẽ |
""s	 " " s |
kë́köl""	 k ë ́ k ö l " " |
dé;	 d é ; |
tsṍlĩkö	 t s õ ́ l ĩ k ö |
dakrò	 d a k r ò |
sarùrù	 s a r ù r ù |
lèkètche	 l è k è t c h e |
kukuèke	 k u k u è k e |
wõwṍnẽla	 w õ w õ ́ n ẽ l a |
bàwẽ	 b à w ẽ |
rñẽ́wẽ	 r ñ ẽ ́ w ẽ |
íkkëtã	 í k k ë t ã |
wö̀të́nẽwã	 w ö ̀ t ë ́ n ẽ w ã |
nãñẽ́wekö	 n ã ñ ẽ ́ w e k ö |
ñĩ́wek	 ñ ĩ ́ w e k |
kë́wë	 k ë ́ w ë |
balë̀nẽ̀wã	 b a l ë ̀ n ẽ ̀ w ã |
nãmã́söl	 n ã m ã ́ s ö l |
yi	 y i |
aláralar	 a l á r a l a r |
dó	 d ó |
tsũk	 t s ũ k |
dá	 d á |
mẽ́	 m ẽ ́ |
yànẽtche	 y à n ẽ t c h e |
yúshka	 y ú s h k a |
bayö̀balö́	 b a y ö ̀ b a l ö ́ |
e'ã	 e ' ã |
kèrwa	 k è r w a |
wébalè	 w é b a l è |
""i'	 " " i ' |
si'	 s i ' |
kã́ñĩ̀nẽ""	 k ã ́ ñ ĩ ̀ n ẽ " " |
wö̀mũ̀ke	 w ö ̀ m ũ ̀ k e |
wö̀mũkèwã""	 w ö ̀ m ũ k è w ã " " |
rpágala	 r p á g a l a |
chàké	 c h à k é |
wë̀nẽ	 w ë ̀ n ẽ |
bö̀t	 b ö ̀ t |
mãñã̀t	 m ã ñ ã ̀ t |
kã́ñìrke""	 k ã ́ ñ ì r k e " " |
wa;	 w a ; |
èk	 è k |
dö̀ppa	 d ö ̀ p p a |
wö̀mũkèwã	 w ö ̀ m ũ k e ̀ w ã |
sĩõ	 s ĩ õ |
'	 ' |
kalö̀nẽ	 k a l ö ̀ n ẽ |
bua'nẽiãnẽ	 b u a ' n ẽ i ã n ẽ |
yulë́la	 y u l ë ́ l a |
bua'rmĩnẽ	 b u a ' r m ĩ n ẽ |
bua'rdànẽ	 b u a ' r d à n ẽ |
rö;	 r ö ; |
kã́bata	 k ã ́ b a t a |
sĩ	 s ĩ |
bayö̀balé	 b a y ö ̀ b a l é |
tö̀kkã	 t ö ̀ k k ã |
tö̀tché	 t ö ̀ t c h é |
tétsã	 t é t s ã |
una	 u n a |
uuu	 u u u |
íjketã	 í j k e t ã |
wö̀të̀nẽtche	 w ö ̀ t ë ̀ n ẽ t c h e |
ẽ̀nĩõõ	 ẽ ̀ n ĩ õ õ |
wö̀të̀nẽwã	 w ö ̀ t ë ̀ n ẽ w ã |
kö̀ièwã	 k ö ̀ i è w ã |
chamũ̀	 c h a m ũ ̀ |
mĩ	 m ĩ |
sũ̀nẽ	 s ũ ̀ n ẽ |
wö̀uk	 w ö ̀ u k |
tsẽ̀keãt	 t s ẽ ̀ k e ã t |
kṍkö	 k õ ́ k ö |
tskurík	 t s k u r í k |
tṍ	 t õ ́ |
mẽrkã	 m ẽ r k ã |
diàse	 d i à s e |
kuwö̀̀	 k u w ö ̀ ̀ |
kuwö̀	 k u w ö ̀ |
lö́lö	 l ö ́ l ö |
kuö̀ë	 k u ö ̀ ë |
bö́	 b ö ́ |
jkö	 j k ö |
ñã́wẽ̀kètche	 ñ ã ́ w ẽ ̀ k è t c h e |
wö̀teulewã	 w ö ̀ t e u l e w ã |
tsĩ̀	 t s ĩ ̀ |
tak	 t a k |
ñã́wẽ̀ke	 ñ ã ́ w ẽ ̀ k e |
bukula'	 b u k u l a ' |
ùjkuö	 ù j k u ö |
èkapë;	 è k a p ë ; |
dalë̀nẽ	 d a l ë ̀ n ẽ |
yulèk	 y u l è k |
e	 e |
yölö̀nṍk	 y ö l ö ̀ n õ ́ k |
kapö̀	 k a p ö ̀ |
dölö̀	 d ö l ö ̀ |
bitsö̀mĩ	 b i t s ö ̀ m ĩ |
ñĩ̀ĩ̀ĩ̀	 ñ ĩ ̀ ĩ ̀ ĩ ̀ |
ppèkènẽ	 p p è k è n ẽ |
ma	 m a |
tũ̀m	 t ũ ̀ m |
kata'	 k a t a ' |
bikèwã	 b i k è w ã |
mũ̀	 m ũ ̀ |
kukõ'	 k u k õ ' |
pṹ	 p ũ ́ |
tsã́téwã	 t s ã ́ t é w ã |
íjkëla	 í j k ë l a |
íjkela;	 í j k e l a ; |
iékã	 i é k ã |
pèkènẽ	 p è k è n ẽ |
tsĩ	 t s ĩ |
skli	 s k l i |
tsã́kuée	 t s ã ́ k u é e |
bitsö̀wẽ̀ke	 b i t s ö ̀ w ẽ ̀ k e |
ñĩ̀ë	 ñ ĩ ̀ ë |
diö̀yö	 d i ö ̀ y ö |
suu	 s u u |
chö́kela	 c h ö ́ k e l a |
wö̀tërulèwã	 w ö ̀ t ë r u l è w ã |
distéwö	 d i s t é w ö |
íjketcha	 í j k e t c h a |
etch	 e t c h |
kṍrkĩ	 k õ ́ r k ĩ |
yuwèkã	 y u w è k ã |
iõ̀kã	 i õ ̀ k ã |
dóyal	 d ó y a l |
kèke	 k è k e |
kiöktsã	 k i ö k t s ã |
sulĩ̀	 s u l ĩ ̀ |
kièkètsã	 k i è k è t s ã |
mõnẽ̀tche	 m õ n ẽ ̀ t c h e |
kiök	 k i ö k |
wẽ́jkëtã	 w ẽ ́ j k ë t ã |
tö̀tchètsã	 t ö ̀ t c h è t s ã |
kũẽ̀ppa	 k ũ ẽ ̀ p p a |
ièã	 i è ã |
ièmĩ̀kã	 i è m ĩ ̀ k ã |
ièppakã	 i è p p a k ã |
́ĩ	 ́ ĩ |
tṹr	 t ũ ́ r |
bulámĩkö	 b u l á m ĩ k ö |
kũẽ̀wã	 k ũ ẽ ̀ w ã |
duwö́wã	 d u w ö ́ w ã |
õ̀n	 õ ̀ n |
të̀nẽ̀wã	 t ë ̀ n ẽ ̀ w ã |
bitèanẽ	 b i t è a n ẽ |
kàle	 k à l e |
tsẽ́mĩ	 t s ẽ ́ m ĩ |
rwó	 r w ó |
du'	 d u ' |
síwẽ̀mĩ	 s í w ẽ ̀ m ĩ |
tsã́kã	 t s ã ́ k ã |
síwẽ̀ppa	 s í w ẽ ̀ p p a |
e'ñẽ́rmã	 e ' ñ ẽ ́ r m ã |
sũwẽ́tche	 s ũ w ẽ ́ t c h e |
ewa	 e w a |
wö̀káwẽ	 w ö ̀ k á w ẽ |
kö̀kã	 k ö ̀ k ã |
sërërërërë	 s ë r ë r ë r ë r ë |
bua'ë!	 b u a ' ë ! |
kũẽ̀rà	 k ũ ẽ ̀ r à |
yú	 y ú |
sã́ũk	 s ã ́ ũ k |
mĩ́tsẽ	 m ĩ ́ t s ẽ |
biètsã	 b i è t s ã |
kũẽ̀	 k ũ ẽ ̀ |
síwẽ̀ke	 s í w ẽ ̀ k e |
dalèkua	 d a l è k u a |
tsébita	 t s é b i t a |
mũlũ̀lka	 m ũ l ũ ̀ l k a |
wö̀ñẽkètche	 w ö ̀ ñ ẽ k è t c h e |
mĩ́r	 m ĩ ́ r |
ë̀;	 ë ̀ ; |
yuwö̀keiã	 y u w ö ̀ k e i ã |
là	 l à |
wẽ́ri	 w ẽ ́ r i |
yànṍk	 y à n õ ́ k |
ñẽ́ẽrönẽ	 ñ ẽ ́ ẽ r ö n ẽ |
también	 t a m b i é n |
mẽ̀kètche;	 m ẽ ̀ k è t c h e ; |
ulàmẽ	 u l à m ẽ |
dàtsĩkenẽ	 d à t s ĩ k e n ẽ |
bitsök	 b i t s ö k |
wĩ̀ẽrö	 w ĩ ̀ ẽ r ö |
wẽ́̀	 w ẽ ́ ̀ |
ñĩ̀köl	 ñ ĩ ̀ k ö l |
ñĩ̀wẽ	 ñ ĩ ̀ w ẽ |
dapàrke	 d a p à r k e |
yö́kĩ	 y ö ́ k ĩ |
wö̀li	 w ö ̀ l i |
wõwṍ	 w õ w õ ́ |
lìrke	 l ì r k e |
katèkètche	 k a t è k è t c h e |
skíke	 s k í k e |
katé	 k a t é |
skíkanẽ	 s k í k a n ẽ |
katànẽ	 k a t à n ẽ |
áù	 á ù |
awé	 a w é |
sulùrkèwã	 s u l ù r k è w ã |
mẽ̀rkèwã	 m ẽ ̀ r k è w ã |
talvez	 t a l v e z |
shkákle	 s h k á k l e |
kàlkicha	 k à l k i c h a |
bayö̀blák	 b a y ö ̀ b l á k |
cherà	 c h e r à |
shkák	 s h k á k |
bakë̀nẽ	 b a k ë ̀ n ẽ |
sulùwẽ	 s u l ù w ẽ |
wẽ́jkëlè	 w ẽ ́ j k ë l è |
wẽ́jkële	 w ẽ ́ j k ë l e |
chebo	 c h e b o |
wéìr	 w é ì r |
sulùõwã	 s u l ù õ w ã |
làr	 l à r |
ñẽ́se	 ñ ẽ ́ s e |
sulùnẽ̀wã	 s u l ù n ẽ ̀ w ã |
chówã	 c h ó w ã |
verdad	 v e r d a d |
ahh	 a h h |
bikèitsèmĩ	 b i k è i t s è m ĩ |
ètk	 è t k |
shṹulat	 s h ũ ́ u l a t |
wìwö	 w ì w ö |
u̠jú̠	 u ̠ j ú ̠ |
tö́	 t ö ́ |
ká̠	 k á ̠ |
tèröl	 t è r ö l |
se'	 s e ' |
e's	 e ' s |
tër	 t ë r |
idirla	 i d i r l a |
e'	 e ' |
dör	 d ö r |
ie'	 i e ' |
dawè	 d a w è |
tè	 t è |
pú	 p ú |
irir	 i r i r |
kàl	 k à l |
wö	 w ö |
iene̠	 i e n e ̠ |
ie	 i e |
i	 i |
wà	 w à |
bë̂r	 b ë ̂ r |
yë̂ar	 y ë ̂ a r |
e'tk	 e ' t k |
ë̀	 ë ̀ |
ú̠jù̠	 ú ̠ j ù ̠ |
tsiö̀	 t s i ö ̀ |
ù	 ù |
batà	 b a t à |
uju	 u j u |
e'kët	 e ' k ë t |
ta̠	 t a ̠ |
bua'	 b u a ' |
wö̀na̠	 w ö ̀ n a ̠ |
dayë̀	 d a y ë ̀ |
yö̀ne̠	 y ö ̀ n e ̠ |
sibö̀	 s i b ö ̀ |
a̠	 a ̠ |
ché	 c h é |
be'	 b e ' |
e̠'	 e ̠ ' |
shkö́bitu̠	 s h k ö ́ b i t u ̠ |
a̠wí̠	 a ̠ w í ̠ |
kò̠s	 k ò ̠ s |
ki̠	 k i ̠ |
dawás	 d a w á s |
tso'	 t s o ' |
sìkuapa	 s ì k u a p a |
icha	 i c h a |
itö̀ièke̠	 i t ö ̀ i è k e ̠ |
no	 n o |
ì	 ì |
se'la	 s e ' l a |
yö́	 y ö ́ |
söla	 s ö l a |
sö	 s ö |
balo'rila	 b a l o ' r i l a |
buáala	 b u á a l a |
balo'ri	 b a l o ' r i |
sharila	 s h a r i l a |
a̠là̠chkala	 a ̠ l à ̠ c h k a l a |
ta̠la	 t a ̠ l a |
ye'	 y e ' |
dawèka̠la	 d a w è k a ̠ l a |
aláköla	 a l á k ö l a |
sû̠	 s û ̠ |
sula'	 s u l a ' |
ichàkökala	 i c h à k ö k a l a |
kirë̀rma̠	 k i r ë ̀ r m a ̠ |
kirë̀rma̠la	 k i r ë ̀ r m a ̠ l a |
wö̀	 w ö ̀ |
a̠la	 a ̠ l a |
kë̀la	 k ë ̀ l a |
aë̀rwala	 a ë ̀ r w a l a |
töla	 t ö l a |
ìla	 ì l a |
aë̀	 a ë ̀ |
ijtsèmi̠la	 i j t s è m i ̠ l a |
à	 à |
kë́këpa	 k ë ́ k ë p a |
i̠'ñe̠	 i ̠ ' ñ e ̠ |
sa'	 s a ' |
tö	 t ö |
mí̠a̠	 m í ̠ a ̠ |
wë'stela	 w ë ' s t e l a |
ta̠î̠ë	 t a ̠ î ̠ ë |
ujté	 u j t é |
ta̠î̠	 t a ̠ î ̠ |
kabéne̠	 k a b é n e ̠ |
we'ine̠	 w e ' i n e ̠ |
si̠à̠rë	 s i ̠ à ̠ r ë |
yàmi̠pa	 y à m i ̠ p a |
we'ike	 w e ' i k e |
wa̠	 w a ̠ |
bua'ë	 b u a ' ë |
kí̠mè̠ke̠	 k í ̠ m è ̠ k e ̠ |
ku̠é̠ki̠	 k u ̠ é ̠ k i ̠ |
é̠n	 é ̠ n |
chak	 c h a k |
kiè	 k i è |
alà	 a l à |
kie	 k i e |
jesús	 j e s ú s |
amén	 a m é n |
ké̠we	 k é ̠ w e |
tsiru'	 t s i r u ' |
tèke̠	 t è k e ̠ |
tsakèke̠	 t s a k è k e ̠ |
é	 é |
ma̠	 m a ̠ |
shkö́wè̠ke̠	 s h k ö ́ w è ̠ k e ̠ |
síkwa	 s í k w a |
të́rulewa̠	 t ë ́ r u l e w a ̠ |
ékëpa	 é k ë p a |
mè̠ke̠ttsa̠	 m è ̠ k e ̠ t t s a ̠ |
dìba	 d ì b a |
sìne̠	 s ì n e ̠ |
kukèke̠	 k u k è k e ̠ |
wö̀ppèke̠	 w ö ̀ p p è k e ̠ |
wèke̠	 w è k e ̠ |
tabèchka	 t a b è c h k a |
ki̠ka	 k i ̠ k a |
blôblô	 b l ô b l ô |
chkà	 c h k à |
páköl	 p á k ö l |
mi̠	 m i ̠ |
mè̠ke̠ka̠	 m è ̠ k e ̠ k a ̠ |
bö'	 b ö ' |
daléwa	 d a l é w a |
mo̠ló̠tsmo̠ló̠ts	 m o ̠ l ó ̠ t s m o ̠ l ó ̠ t s |
íyi	 í y i |
ièka̠	 i è k a ̠ |
i̠a̠	 i ̠ a ̠ |
sìkua	 s ì k u a |
canela	 c a n e l a |
e̠ma̠	 e ̠ m a ̠ |
dlásháwö	 d l á s h á w ö |
shá̠mé̠la	 s h á ̠ m é ̠ l a |
apà	 a p à |
butrèke̠wa̠	 b u t r è k e ̠ w a ̠ |
yë́jkuö	 y ë ́ j k u ö |
wa	 w a |
ta̠wè̠ke̠	 t a ̠ w è ̠ k e ̠ |
bulu'pa	 b u l u ' p a |
bueno	 b u e n o |
í̠e̠	 í ̠ e ̠ |
rè	 r è |
e'ta̠	 e ' t a ̠ |
yulár	 y u l á r |
wö̀ke̠	 w ö ̀ k e ̠ |
wè̠s	 w è ̠ s |
a'r	 a ' r |
sa̠wè̠	 s a ̠ w è ̠ |
bribripa	 b r i b r i p a |
ák	 á k |
mè̠a̠t	 m è ̠ a ̠ t |
wö́köl	 w ö ́ k ö l |
kë̀	 k ë ̀ |
ô̠ka	 ô ̠ k a |
mè̠ne̠a̠t	 m è ̠ n e ̠ a ̠ t |
wö́k	 w ö ́ k |
a̠wì̠	 a ̠ w ì ̠ |
pàke	 p à k e |
rë'ka̠	 r ë ' k a ̠ |
dià	 d i à |
kièke̠	 k i è k e ̠ |
ká̠ska	 k á ̠ s k a |
ma̠nè̠te̠	 m a ̠ n è ̠ t e ̠ |
ditsö̀wö	 d i t s ö ̀ w ö |
ikuö̀wö	 i k u ö ̀ w ö |
ése	 é s e |
ditséwö	 d i t s é w ö |
mì̠ka̠	 m ì ̠ k a ̠ |
tskìne̠	 t s k ì n e ̠ |
sulàyöm	 s u l à y ö m |
me̠'a̠t	 m e ̠ ' a ̠ t |
ñá̠no̠	 ñ á ̠ n o ̠ |
katáno̠	 k a t á n o ̠ |
chkö́köl	 c h k ö ́ k ö l |
sè̠nu̠köl	 s è ̠ n u ̠ k ö l |
î̠ñe̠	 î ̠ ñ e ̠ |
katèke̠	 k a t è k e ̠ |
mì̠k	 m ì ̠ k |
nê̠ne̠	 n ê ̠ n e ̠ |
hasta	 h a s t a |
rö	 r ö |
sì̠na̠	 s ì ̠ n a ̠ |
éjkë	 é j k ë |
i̠à̠na̠	 i ̠ à ̠ n a ̠ |
tso'se̠n	 t s o ' s e ̠ n |
ùrke̠	 ù r k e ̠ |
ujtö̀ie	 u j t ö ̀ i e |
sé̠rke̠	 s é ̠ r k e ̠ |
bùsila	 b ù s i l a |
wö́ulâù̠ke̠	 w ö ́ u l â ù ̠ k e ̠ |
ö	 ö |
bùsi	 b ù s i |
ulà	 u l à |
batsèmi̠	 b a t s è m i ̠ |
mà̠so	 m à ̠ s o |
kú̠rmi̠	 k ú ̠ r m i ̠ |
wö́ulâna̠tketke	 w ö ́ u l â n a ̠ t k e t k e |
éki	 é k i |
sé̠	 s é ̠ |
tsè̠ke̠	 t s è ̠ k e ̠ |
éyökie	 é y ö k i e |
dö̀ka̠	 d ö ̀ k a ̠ |
ékölëme̠	 é k ö l ë m e ̠ |
rö̀	 r ö ̀ |
ké̠	 k é ̠ |
blo'	 b l o ' |
yèke̠	 y è k e ̠ |
chkö̀ke̠rak	 c h k ö ̀ k e ̠ r a k |
tso'rak	 t s o ' r a k |
ñî̠	 ñ î ̠ |
ñì̠	 ñ ì ̠ |
kímu̠kdak	 k í m u ̠ k d a k |
wé̠se	 w é ̠ s e |
yìr	 y ì r |
ièke̠	 i è k e ̠ |
ñé̠	 ñ é ̠ |
wé̠shke̠	 w é ̠ s h k e ̠ |
mì̠kle	 m ì ̠ k l e |
a̠wí̠es	 a ̠ w í ̠ e s |
e'rör	 e ' r ö r |
wé̠	 w é ̠ |
e'köl	 e ' k ö l |
yì	 y ì |
bua'r	 b u a ' r |
kià̠na̠	 k i à ̠ n a ̠ |
e̠'rö	 e ̠ ' r ö |
wákpa	 w á k p a |
sé̠ndak	 s é ̠ n d a k |
ujtö̀	 u j t ö ̀ |
sé̠n	 s é ̠ n |
tsikìne̠	 t s i k ì n e ̠ |
amù̠bli	 a m ù ̠ b l i |
talàne̠	 t a l à n e ̠ |
mama	 m a m a |
bö̀k	 b ö ̀ k |
ma̠nè̠ta̠	 m a ̠ n è ̠ t a ̠ |
ñe̠'	 ñ e ̠ ' |
klö̀	 k l ö ̀ |
este	 e s t e |
boca	 b o c a |
urén	 u r é n |
ká̠batà	 k á ̠ b a t à |
ma̠nè̠t	 m a ̠ n è ̠ t |
kibí	 k i b í |
que	 q u e |
ya	 y a |
yö	 y ö |
esposo	 e s p o s o |
ta̠'	 t a ̠ ' |
dë'rö	 d ë ' r ö |
tsú̠k	 t s ú ̠ k |
entonces	 e n t o n c e s |
dìwö	 d ì w ö |
dé	 d é |
kúkur	 k ú k u r |
pàköl	 p à k ö l |
i'	 i ' |
pero	 p e r o |
dë'	 d ë ' |
dë'tsa̠	 d ë ' t s a ̠ |
sè̠ne̠	 s è ̠ n e ̠ |
yàk	 y à k |
sa̠	 s a ̠ |
casi	 c a s i |
e'k	 e ' k |
ukö̀ki̠	 u k ö ̀ k i ̠ |
yö'	 y ö ' |
ahora	 a h o r a |
sí	 s í |
tkë̀r	 t k ë ̀ r |
ká̠m	 k á ̠ m |
chö̀wa	 c h ö ̀ w a |
yë́	 y ë ́ |
si̠wa̠'	 s i ̠ w a ̠ ' |
të'r	 t ë ' r |
ala'rala	 a l a ' r a l a |
tskìna̠	 t s k ì n a ̠ |
kù̠na̠	 k ù ̠ n a ̠ |
ie'pa	 i e ' p a |
hospital	 h o s p i t a l |
talàna̠	 t a l à n a ̠ |
wö́ulâa̠'	 w ö ́ u l â a ̠ ' |
sa̠ú̠k	 s a ̠ ú ̠ k |
pôó̠rulur	 p ô ó ̠ r u l u r |
kibìna̠	 k i b ì n a ̠ |
mí̠tke	 m í ̠ t k e |
solo	 s o l o |
à̠te̠	 à ̠ t e ̠ |
e'köla	 e ' k ö l a |
porque	 p o r q u e |
dë'u̠ntu	 d ë ' u ̠ n t u |
e'tala	 e ' t a l a |
chóla	 c h ó l a |
chë'wa	 c h ë ' w a |
ajá	 a j á |
ujú	 u j ú |
como	 c o m o |
ajké̠	 a j k é ̠ |
propio	 p r o p i o |
ye'r	 y e ' r |
mí̠k	 m í ̠ k |
alí	 a l í |
cortadora	 c o r t a d o r a |
té	 t é |
kókó	 k ó k ó |
détsa̠	 d é t s a ̠ |
tal	 t a l |
vez	 v e z |
saco	 s a c o |
be'r	 b e ' r |
mé̠a̠t	 m é ̠ a ̠ t |
dö̀	 d ö ̀ |
su̠lì̠tu	 s u ̠ l ì ̠ t u |
mé̠r	 m é ̠ r |
síu̠k	 s í u ̠ k |
bétk	 b é t k |
sìna̠wa̠	 s ì n a ̠ w a ̠ |
sìna̠	 s ì n a ̠ |
tkë́l	 t k ë ́ l |
kukèke̠tke	 k u k è k e ̠ t k e |
ù̠	 ù ̠ |
bá	 b á |
sa̠ú̠	 s a ̠ ú ̠ |
kukö́k	 k u k ö ́ k |
katùna̠	 k a t ù n a ̠ |
wö̀ishchèke̠	 w ö ̀ i s h c h è k e ̠ |
ajkuö́lit	 a j k u ö ́ l i t |
yéulur	 y é u l u r |
máquina	 m á q u i n a |
sa'r	 s a ' r |
i̠â̠chkí	 i ̠ â ̠ c h k í |
kukö̀ke̠	 k u k ö ̀ k e ̠ |
a'	 a ' |
pàkeke̠	 p à k e k e ̠ |
tskírke̠	 t s k í r k e ̠ |
chè	 c h è |
mí̠ka̠	 m í ̠ k a ̠ |
e'rö	 e ' r ö |
ñá̠	 ñ á ̠ |
a̠mì̠	 a ̠ m ì ̠ |
kiàna̠	 k i à n a ̠ |
pàkuemle̠	 p à k u e m l e ̠ |
óköpa	 ó k ö p a |
rë́ka̠	 r ë ́ k a ̠ |
wíköl	 w í k ö l |
pàtkeke̠	 p à t k e k e ̠ |
mè̠bitu̠	 m è ̠ b i t u ̠ |
yawè	 y a w è |
di'	 d i ' |
rë́ka̠i̠a̠	 r ë ́ k a ̠ i ̠ a ̠ |
pà	 p à |
sùne̠	 s ù n e ̠ |
ka̠nè̠u̠k	 k a ̠ n è ̠ u ̠ k |
bitè̠	 b i t è ̠ |
pàtkebitu̠	 p à t k e b i t u ̠ |
chèa̠t	 c h è a ̠ t |
ké	 k é |
ka̠nè̠u̠	 k a ̠ n è ̠ u ̠ |
mí̠tkemu̠le̠	 m í ̠ t k e m u ̠ l e ̠ |
ujtè	 u j t è |
mí̠ke̠mu̠le̠	 m í ̠ k e ̠ m u ̠ l e ̠ |
satë̀	 s a t ë ̀ |
kìta̠	 k ì t a ̠ |
mé̠mu̠le̠	 m é ̠ m u ̠ l e ̠ |
sa̠wé̠	 s a ̠ w é ̠ |
mò̠ki̠	 m ò ̠ k i ̠ |
yë'	 y ë ' |
se'r	 s e ' r |
ka̠nè̠o̠'	 k a ̠ n è ̠ o ̠ ' |
kí̠	 k í ̠ |
bakò̠s	 b a k ò ̠ s |
a̠ñì̠es	 a ̠ ñ ì ̠ e s |
i̠ù̠te	 i ̠ ù ̠ t e |
chèrak	 c h è r a k |
idir	 i d i r |
katè	 k a t è |
ajkë́u̠k	 a j k ë ́ u ̠ k |
kàne̠	 k à n e ̠ |
a̠ñì̠	 a ̠ ñ ì ̠ |
yö̀ki̠	 y ö ̀ k i ̠ |
à̠s	 à ̠ s |
tsikìna̠	 t s i k ì n a ̠ |
réwa̠	 r é w a ̠ |
sè̠nu̠k	 s è ̠ n u ̠ k |
dalë́ri	 d a l ë ́ r i |
dalö̀iökdak	 d a l ö ̀ i ö k d a k |
yë'a̠t	 y ë ' a ̠ t |
tsikírke̠	 t s i k í r k e ̠ |
ñé̠e̠	 ñ é ̠ e ̠ |
tsá̠we	 t s á ̠ w e |
dë́bitu̠dak	 d ë ́ b i t u ̠ d a k |
bö́l	 b ö ́ l |
ma̠ñá̠l	 m a ̠ ñ á ̠ l |
ë̀me̠	 ë ̀ m e ̠ |
e'pa	 e ' p a |
wé	 w é |
wéla	 w é l a |
tkë́rka̠	 t k ë ́ r k a ̠ |
tkë́rka̠rak	 t k ë ́ r k a ̠ r a k |
alákölpa	 a l á k ö l p a |
bitu̠ke̠rak	 b i t u ̠ k e ̠ r a k |
ala'r	 a l a ' r |
tsikírke̠tke	 t s i k í r k e ̠ t k e |
awá	 a w á |
óköm	 ó k ö m |
kapèblök	 k a p è b l ö k |
bátsena̠mu̠le̠	 b á t s e n a ̠ m u ̠ l e ̠ |
ka̠nè̠wè̠ke̠	 k a ̠ n è ̠ w è ̠ k e ̠ |
wák	 w á k |
ka'	 k a ' |
bák	 b á k |
tsîr	 t s î r |
ká̠mî̠ë	 k á ̠ m î ̠ ë |
cabagra	 c a b a g r a |
ajkö̀	 a j k ö ̀ |
a̠wí̠she̠t	 a ̠ w í ̠ s h e ̠ t |
ë̀ka̠	 ë ̀ k a ̠ |
santa	 s a n t a |
elena	 e l e n a |
puente	 p u e n t e |
mí̠ke̠	 m í ̠ k e ̠ |
mú̠köl	 m ú ̠ k ö l |
talâo̠	 t a l â o ̠ |
mì̠	 m ì ̠ |
êköl	 ê k ö l |
wë̂i̠a̠	 w ë ̂ i ̠ a ̠ |
escuela	 e s c u e l a |
skà	 s k à |
ichàkeke̠	 i c h à k e k e ̠ |
wö́blar	 w ö ́ b l a r |
ni̠mà̠	 n i ̠ m à ̠ |
kalíu̠k	 k a l í u ̠ k |
mí̠kalè	 m í ̠ k a l è |
ka̠ñí̠k	 k a ̠ ñ í ̠ k |
bàn	 b à n |
ùyöm	 ù y ö m |
wé̠alè	 w é ̠ a l è |
dë́rule	 d ë ́ r u l e |
apàkö́	 a p à k ö ́ |
ña̠	 ñ a ̠ |
kalíwe̠	 k a l í w e ̠ |
ukö̀	 u k ö ̀ |
mí̠	 m í ̠ |
bö	 b ö |
wö̀iewa̠	 w ö ̀ i e w a ̠ |
á̠jà̠	 á ̠ j à ̠ |
pues	 p u e s |
té̠rke̠	 t é ̠ r k e ̠ |
ké̠kra	 k é ̠ k r a |
diö́	 d i ö ́ |
río	 r í o |
y	 y |
cordillera	 c o r d i l l e r a |
mi̠k	 m i ̠ k |
muchos	 m u c h o s |
digamos	 d i g a m o s |
i̠â̠i̠â̠	 i ̠ â ̠ i ̠ â ̠ |
jké̠	 j k é ̠ |
sàl	 s à l |
ö̀k	 ö ̀ k |
íyiwak	 í y i w a k |
êrë	 ê r ë |
chìchi	 c h ì c h i |
yë́s	 y ë ́ s |
ajkè̠n	 a j k è ̠ n |
ni̠mé̠i	 n i ̠ m é ̠ i |
mu̠lû̠wak	 m u ̠ l û ̠ w a k |
dakòlwak	 d a k ò l w a k |
wàtak	 w à t a k |
kàlni̠me̠	 k à l n i ̠ m e ̠ |
bulë̀rwak	 b u l ë ̀ r w a k |
ñí̠we	 ñ í ̠ w e |
na̠ñé̠we	 n a ̠ ñ é ̠ w e |
mì̠kalê	 m ì ̠ k a l ê |
ñê̠es	 ñ ê ̠ e s |
bìt	 b ì t |
ulàttöu̠k	 u l à t t ö u ̠ k |
aû	 a û |
bö̀tk	 b ö ̀ t k |
ma̠ñà̠tk	 m a ̠ ñ à ̠ t k |
tsé̠a̠t	 t s é ̠ a ̠ t |
kapë́rule	 k a p ë ́ r u l e |
kapö̀ke̠	 k a p ö ̀ k e ̠ |
sík	 s í k |
kö̀	 k ö ̀ |
yawèka̠	 y a w è k a ̠ |
dikì̠	 d i k ì ̠ |
chkö̀	 c h k ö ̀ |
mí̠rule	 m í ̠ r u l e |
àrros	 à r r o s |
así	 a s í |
kalö́m	 k a l ö ́ m |
mismo	 m i s m o |
sí̠	 s í ̠ |
dapö̀	 d a p ö ̀ |
ku̠é̠	 k u ̠ é ̠ |
bìl	 b ì l |
yàmi̠	 y à m i ̠ |
nada	 n a d a |
sú̠rule	 s ú ̠ r u l e |
chö̀ke̠wa	 c h ö ̀ k e ̠ w a |
ìs	 ì s |
shkè̠na̠	 s h k è ̠ n a ̠ |
í̠ma̠	 í ̠ m a ̠ |
natividad	 n a t i v i d a d |
alto	 a l t o |
dùriña̠k	 d ù r i ñ a ̠ k |
wé̠jkë	 w é ̠ j k ë |
à̠ta̠	 à ̠ t a ̠ |
élke	 é l k e |
ma̠ñà̠t	 m a ̠ ñ à ̠ t |
ulàt	 u l à t |
shkö́k	 s h k ö ́ k |
ká̠pakö	 k á ̠ p a k ö |
wös	 w ö s |
dë́ka̠	 d ë ́ k a ̠ |
pàkö	 p à k ö |
me̠'	 m e ̠ ' |
ajkà	 a j k à |
a̠mé̠a̠t	 a ̠ m é ̠ a ̠ t |
dë́bitu̠	 d ë ́ b i t u ̠ |
dù	 d ù |
di'la	 d i ' l a |
dùri	 d ù r i |
akuö́k	 a k u ö ́ k |
me̠'ka̠	 m e ̠ ' k a ̠ |
mí̠chôka̠	 m í ̠ c h ô k a ̠ |
déka̠	 d é k a ̠ |
na̠mà̠söl	 n a ̠ m à ̠ s ö l |
ká̠bata	 k á ̠ b a t a |
tkër	 t k ë r |
ie'r	 i e ' r |
na̠mà̠ie	 n a ̠ m à ̠ i e |
e'r	 e ' r |
átuwö	 á t u w ö |
a̠me̠'a̠t	 a ̠ m e ̠ ' a ̠ t |
dalö̀	 d a l ö ̀ |
tulúr	 t u l ú r |
dalóie	 d a l ó i e |
ë́ltë	 ë ́ l t ë |
ditsö̀	 d i t s ö ̀ |
ajkö́nu̠k	 a j k ö ́ n u ̠ k |
ajkö́no̠	 a j k ö ́ n o ̠ |
na̠mé̠söl	 n a ̠ m é ̠ s ö l |
bë̂rie	 b ë ̂ r i e |
tso'tke	 t s o ' t k e |
ta̠'tke	 t a ̠ ' t k e |
blë'këkëpa	 b l ë ' k ë k ë p a |
i̠â̠chki	 i ̠ â ̠ c h k i |
ujché̠r	 u j c h é ̠ r |
sibö̀r	 s i b ö ̀ r |
pàka'	 p à k a ' |
pàkane̠	 p à k a n e ̠ |
tsítsir	 t s í t s i r |
wö́su̠k	 w ö ́ s u ̠ k |
ka̠nè̠blë'	 k a ̠ n è ̠ b l ë ' |
cha̠mù̠	 c h a ̠ m ù ̠ |
kuátkö̀ke̠	 k u á t k ö ̀ k e ̠ |
yawö́k	 y a w ö ́ k |
sè̠no̠	 s è ̠ n o ̠ |
mi̠kalè	 m i ̠ k a l è |
ikuö̀	 i k u ö ̀ |
itö̀tèke̠	 i t ö ̀ t è k e ̠ |
wë̀na̠la	 w ë ̀ n a ̠ l a |
ka̠nè̠we̠ke̠	 k a ̠ n è ̠ w e ̠ k e ̠ |
bíl	 b í l |
shkà̠ta̠ne̠	 s h k à ̠ t a ̠ n e ̠ |
dö̀mi̠	 d ö ̀ m i ̠ |
dabòm	 d a b ò m |
bö́yök	 b ö ́ y ö k |
sé̠r	 s é ̠ r |
tsè	 t s è |
yàmi̠pala	 y à m i ̠ p a l a |
ka̠nè̠we̠	 k a ̠ n è ̠ w e ̠ |
inú̠köl	 i n ú ̠ k ö l |
u̠'ù̠	 u ̠ ' ù ̠ |
wàto̠no̠	 w à t o ̠ n o ̠ |
ë́	 ë ́ |
wakpa	 w a k p a |
ka̠nè̠blö̀ke̠	 k a ̠ n è ̠ b l ö ̀ k e ̠ |
sa̠wè̠ke̠	 s a ̠ w è ̠ k e ̠ |
ka̠nè̠blöke̠	 k a ̠ n è ̠ b l ö k e ̠ |
àrrosla	 à r r o s l a |
kuatkè	 k u a t k è |
katàno̠	 k a t à n o ̠ |
alátsitsi	 a l á t s i t s i |
êla	 ê l a |
wêikö	 w ê i k ö |
pàkano̠	 p à k a n o ̠ |
démi̠	 d é m i ̠ |
e't	 e ' t |
tulúa̠t	 t u l ú a ̠ t |
sulàyibi	 s u l à y i b i |
katàblë'	 k a t à b l ë ' |
diö̀ya'	 d i ö ̀ y a ' |
suléyibi	 s u l é y i b i |
wébalök	 w é b a l ö k |
kirë̀rma̠pa	 k i r ë ̀ r m a ̠ p a |
i̠	 i ̠ |
bâwe̠	 b â w e ̠ |
tsë'ka	 t s ë ' k a |
mâ̠ma̠	 m â ̠ m a ̠ |
oro	 o r o |
kâne̠	 k â n e ̠ |
tsiríu̠k	 t s i r í u ̠ k |
kö́k	 k ö ́ k |
dalö̀iök	 d a l ö ̀ i ö k |
ajkö́nu̠ne̠	 a j k ö ́ n u ̠ n e ̠ |
sulû	 s u l û |
wámblër	 w á m b l ë r |
chö̀ulur	 c h ö ̀ u l u r |
dawö̀ulur	 d a w ö ̀ u l u r |
ñî̠köl	 ñ î ̠ k ö l |
i̠à̠rtse̠	 i ̠ à ̠ r t s e ̠ |
e'töm	 e ' t ö m |
ttö̀	 t t ö ̀ |
ie'rö	 i e ' r ö |
kuátkë	 k u á t k ë |
ulìta̠ne̠	 u l ì t a ̠ n e ̠ |
mì̠ne̠	 m ì ̠ n e ̠ |
kuátkök	 k u á t k ö k |
wa'ñe̠	 w a ' ñ e ̠ |
aì	 a ì |
chô	 c h ô |
wö̀wo̠	 w ö ̀ w o ̠ |
tsikírmi̠	 t s i k í r m i ̠ |
è̠ne̠wa̠mi̠	 è ̠ n e ̠ w a ̠ m i ̠ |
mì̠kalè	 m ì ̠ k a l è |
dè	 d è |
tsiríwe̠ke̠	 t s i r í w e ̠ k e ̠ |
tsiríwe̠	 t s i r í w e ̠ |
ké̠bata	 k é ̠ b a t a |
me̠'ie	 m e ̠ ' i e |
kiéka̠	 k i é k a ̠ |
kìne̠ka̠	 k ì n e ̠ k a ̠ |
kièka̠	 k i è k a ̠ |
à̠na̠wa̠	 à ̠ n a ̠ w a ̠ |
tsétse	 t s é t s e |
wámblö	 w á m b l ö |
kiàne̠	 k i à n e ̠ |
kë́sik	 k ë ́ s i k |
balö̀mi̠ne̠	 b a l ö ̀ m i ̠ n e ̠ |
ujtèmi̠	 u j t è m i ̠ |
wö́kir	 w ö ́ k i r |
dalë́wè̠	 d a l ë ́ w è ̠ |
kirìwe̠wa̠	 k i r ì w e ̠ w a ̠ |
kiár	 k i á r |
ká̠wö	 k á ̠ w ö |
mé̠rmi̠	 m é ̠ r m i ̠ |
da'	 d a ' |
kú̠nu̠k	 k ú ̠ n u ̠ k |
ajkö́ne̠	 a j k ö ́ n e ̠ |
dö̀pa	 d ö ̀ p a |
ska	 s k a |
wake'	 w a k e ' |
à̠te̠tke	 à ̠ t e ̠ t k e |
itö̀	 i t ö ̀ |
es	 e s |
érë	 é r ë |
ka̠nè̠	 k a ̠ n è ̠ |
ka̠nè̠wè̠mi̠	 k a ̠ n è ̠ w è ̠ m i ̠ |
púchi	 p ú c h i |
tsikìnu̠k	 t s i k ì n u ̠ k |
sha̠lê̠lê̠	 s h a ̠ l ê ̠ l ê ̠ |
ë	 ë |
kicha	 k i c h a |
chö	 c h ö |
shà̠	 s h à ̠ |
báne̠t	 b á n e ̠ t |
cha̠mù̠la	 c h a ̠ m ù ̠ l a |
kuátkèmi̠	 k u á t k è m i ̠ |
kuátke	 k u á t k e |
wö̀batse	 w ö ̀ b a t s e |
ésela	 é s e l a |
tsikír	 t s i k í r |
mí̠tkene̠	 m í ̠ t k e n e ̠ |
mú̠	 m ú ̠ |
kuála	 k u á l a |
ka̠nè̠o̠rmi̠	 k a ̠ n è ̠ o ̠ r m i ̠ |
iku̠á̠ki̠	 i k u ̠ á ̠ k i ̠ |
sé̠râ	 s é ̠ r â |
a̠mù̠bli	 a ̠ m ù ̠ b l i |
coroma	 c o r o m a |
i̠à̠ne̠	 i ̠ à ̠ n e ̠ |
ma̠nè̠ne̠tsa̠	 m a ̠ n è ̠ n e ̠ t s a ̠ |
bribriwak	 b r i b r i w a k |
bikéitse̠	 b i k é i t s e ̠ |
a̠mè̠ne̠a̠t	 a ̠ m è ̠ n e ̠ a ̠ t |
a̠mè̠ne̠	 a ̠ m è ̠ n e ̠ |
ië̀ka̠	 i ë ̀ k a ̠ |
ku̠é̠i̠	 k u ̠ é ̠ i ̠ |
siempre	 s i e m p r e |
alè	 a l è |
rë	 r ë |
të̀	 t ë ̀ |
tu̠è̠	 t u ̠ è ̠ |
kuáble	 k u á b l e |
átu	 á t u |
ali'	 a l i ' |
apì	 a p ì |
sawák	 s a w á k |
wè̠	 w è ̠ |
ajkàyë'	 a j k à y ë ' |
ka̠nè̠ble	 k a ̠ n è ̠ b l e |
ala'rla	 a l a ' r l a |
tièra	 t i è r a |
êjkë	 ê j k ë |
ká̠ñi̠rke̠	 k á ̠ ñ i ̠ r k e ̠ |
ká̠tuírke̠	 k á ̠ t u í r k e ̠ |
kó̠	 k ó ̠ |
íjkë	 í j k ë |
ma̠lé̠pa	 m a ̠ l é ̠ p a |
wö̀blao̠'	 w ö ̀ b l a o ̠ ' |
ka̠nè̠blök	 k a ̠ n è ̠ b l ö k |
yulö́k	 y u l ö ́ k |
àk	 à k |
balèku̠	 b a l è k u ̠ |
balè	 b a l è |
sulûë	 s u l û ë |
ka̠nè̠bleke̠	 k a ̠ n è ̠ b l e k e ̠ |
ajkàche	 a j k à c h e |
yö̂mi̠	 y ö ̂ m i ̠ |
yö̀ne̠mi̠	 y ö ̀ n e ̠ m i ̠ |
varios	 v a r i o s |
wö́ulârke̠	 w ö ́ u l â r k e ̠ |
wö́ulâne̠	 w ö ́ u l â n e ̠ |
tsö́k	 t s ö ́ k |
erë	 e r ë |
wö̂ikèke̠	 w ö ̂ i k è k e ̠ |
wö́ulâo̠	 w ö ́ u l â o ̠ |
wö́ulâo̠mi̠	 w ö ́ u l â o ̠ m i ̠ |
é̠ma̠	 é ̠ m a ̠ |
raúl	 r a ú l |
méndez	 m é n d e z |
ujchè̠n	 u j c h è ̠ n |
à̠	 à ̠ |
bikéitsèke̠	 b i k é i t s è k e ̠ |
yàli	 y à l i |
apàke	 a p à k e |
alatsítsi	 a l a t s í t s i |
wö̂ikmi̠	 w ö ̂ i k m i ̠ |
alàtsítsi	 a l à t s í t s i |
wö̂ik	 w ö ̂ i k |
bitu̠	 b i t u ̠ |
wö̂ike	 w ö ̂ i k e |
wö̂ìna̠	 w ö ̂ ì n a ̠ |
tka'	 t k a ' |
tawàlia	 t a w à l i a |
ñé̠es	 ñ é ̠ e s |
kë́këpala	 k ë ́ k ë p a l a |
àlim	 à l i m |
pa	 p a |
kö̀chi	 k ö ̀ c h i |
krò	 k r ò |
bàka	 b à k a |
kabàiö	 k a b à i ö |
kalö̀	 k a l ö ̀ |
o̠'mi̠k	 o ̠ ' m i ̠ k |
kàlkö	 k à l k ö |
dóma̠le̠	 d ó m a ̠ l e ̠ |
ka̠nè̠wo̠	 k a ̠ n è ̠ w o ̠ |
ichö́kle	 i c h ö ́ k l e |
ró	 r ó |
shirë́kö	 s h i r ë ́ k ö |
klòkö	 k l ò k ö |
shu̠lé̠	 s h u ̠ l é ̠ |
sö̀kkö	 s ö ̀ k k ö |
dapáwe̠ma̠le̠	 d a p á w e ̠ m a ̠ l e ̠ |
páliu̠köl	 p á l i u ̠ k ö l |
aîkö	 a î k ö |
bitù̠ke̠ma̠le̠	 b i t ù ̠ k e ̠ m a ̠ l e ̠ |
tsè̠	 t s è ̠ |
bítkuak	 b í t k u a k |
bö́tkuak	 b ö ́ t k u a k |
tkë́yök	 t k ë ́ y ö k |
sìtla	 s ì t l a |
wö̂iko	 w ö ̂ i k o |
étkuak	 é t k u a k |
tkabë̀	 t k a b ë ̀ |
kuéwa̠	 k u é w a ̠ |
ie'par	 i e ' p a r |
tsî̠	 t s î ̠ |
âr	 â r |
apàkö	 a p à k ö |
bulù	 b u l ù |
tsítsipala	 t s í t s i p a l a |
talâr	 t a l â r |
pàtu	 p à t u |
pú̠	 p ú ̠ |
irö̀	 i r ö ̀ |
cómo	 c ó m o |
se	 s e |
llama	 l l a m a |
kayö́	 k a y ö ́ |
dùsi̠a̠	 d ù s i ̠ a ̠ |
pík	 p í k |
ku̠ka̠'	 k u ̠ k a ̠ ' |
wö́ni̠k	 w ö ́ n i ̠ k |
pulë̀	 p u l ë ̀ |
tsítsipa	 t s í t s i p a |
kalö'wo̠	 k a l ö ' w o ̠ |
shù̠	 s h ù ̠ |
mâ̠tkle	 m â ̠ t k l e |
apàto	 a p à t o |
na̠mù̠	 n a ̠ m ù ̠ |
akà	 a k à |
talók	 t a l ó k |
akàla	 a k à l a |
pà̠rlor	 p à ̠ r l o r |
wë́	 w ë ́ |
jueputa	 j u e p u t a |
si̠nà̠s	 s i ̠ n à ̠ s |
kö	 k ö |
vea	 v e a |
bakèla	 b a k è l a |
bakè	 b a k è |
bika'	 b i k a ' |
yë̀ñapala	 y ë ̀ ñ a p a l a |
pàtököl	 p à t ö k ö l |
wéblö	 w é b l ö |
tsè̠bitu̠	 t s è ̠ b i t u ̠ |
dalé	 d a l é |
ujtö́	 u j t ö ́ |
tsî̠ne̠t	 t s î ̠ n e ̠ t |
krá	 k r á |
wö́rki̠	 w ö ́ r k i ̠ |
kuë̀	 k u ë ̀ |
wì̠m	 w ì ̠ m |
wìm	 w ì m |
kachúk	 k a c h ú k |
alö̀buk	 a l ö ̀ b u k |
urrì	 u r r ì |
dakòlum	 d a k ò l u m |
stsí	 s t s í |
wàpie	 w à p i e |
ês	 ê s |
biké	 b i k é |
apàyo	 a p à y o |
wé̠s	 w é ̠ s |
batséi	 b a t s é i |
iki'wè̠ka̠	 i k i ' w è ̠ k a ̠ |
iska	 i s k a |
wé̠ma̠le̠	 w é ̠ m a ̠ l e ̠ |
tsé̠mi̠	 t s é ̠ m i ̠ |
tsule'	 t s u l e ' |
e'ta	 e ' t a |
shù̠aline̠	 s h ù ̠ a l i n e ̠ |
bikéitse	 b i k é i t s e |
batsé	 b a t s é |
bukulú	 b u k u l ú |
ña̠là̠	 ñ a ̠ l à ̠ |
tse̠ke̠	 t s e ̠ k e ̠ |
katúr	 k a t ú r |
klö́m	 k l ö ́ m |
klö́bli	 k l ö ́ b l i |
sé̠se̠	 s é ̠ s e ̠ |
sé̠se̠la	 s é ̠ s e ̠ l a |
yè	 y è |
kuáblök	 k u á b l ö k |
buë'	 b u ë ' |
kuá	 k u á |
wé̠alê	 w é ̠ a l ê |
el	 e l |
muchacho	 m u c h a c h o |
akë́chkeël	 a k ë ́ c h k e ë l |
êskapë	 ê s k a p ë |
tsîrlaël	 t s î r l a ë l |
stsa'wö	 s t s a ' w ö |
colegio	 c o l e g i o |
ka̠nè̠blö	 k a ̠ n è ̠ b l ö |
wö̀blane̠	 w ö ̀ b l a n e ̠ |
ñè̠	 ñ è ̠ |
ñè̠ke̠	 ñ è ̠ k e ̠ |
na̠i̠'chka	 n a ̠ i ̠ ' c h k a |
katàne̠	 k a t à n e ̠ |
à̠a̠	 à ̠ a ̠ |
na̠i̠'	 n a ̠ i ̠ ' |
ditsö̀wöpa	 d i t s ö ̀ w ö p a |
shtàwẽ̀mĩ	 s h t à w ẽ ̀ m ĩ |
sĩõ'tãmĩ	 s ĩ õ ' t ã m ĩ |
	  |
wẽ̀s	 w ẽ ̀ s |
yö̀rmĩ	 y ö ̀ r m ĩ |
kãnẽ̀ũk	 k ã n ẽ ̀ ũ k |
yö̀rke	 y ö ̀ r k e |
mĩ̀kã	 m ĩ ̀ k ã |
yö̀rkèmĩ	 y ö ̀ r k è m ĩ |
batséitsèke	 b a t s é i t s è k e |
kãnẽ̀wẽ̀ke	 k ã n ẽ ̀ w ẽ ̀ k e |
kõ̀s	 k õ ̀ s |
ẽ'	 ẽ ' |
yawö̀ke	 y a w ö ̀ k e |
cha	 c h a |
kṍwötã	 k õ ́ w ö t ã |
íñẽ	 í ñ ẽ |
ã	 ã |
yuwè	 y u w è |
ĩ́ẽ	 ĩ ́ ẽ |
tchë̀r	 t c h ë ̀ r |
mṹ	 m ũ ́ |
yuwök	 y u w ö k |
chèmĩ	 c h è m ĩ |
wẽ́	 w ẽ ́ |
wĩ́se	 w ĩ ́ s e |
yuwákle	 y u w á k l e |
kĩ	 k ĩ |
kiànẽ	 k i à n ẽ |
yö̀r	 y ö ̀ r |
íñe	 í ñ e |
chàkök	 c h à k ö k |
dàtsĩtche	 d à t s ĩ t c h e |
mĩ̀tche	 m ĩ ̀ t c h e |
éẽrö	 é ẽ r ö |
éẽ	 é ẽ |
klö̀wẽ̀ke	 k l ö ̀ w ẽ ̀ k e |
tsuru'	 t s u r u ' |
kuö̀k	 k u ö ̀ k |
bikàkla	 b i k à k l a |
dur	 d u r |
ès	 è s |
bikékla	 b i k é k l a |
dùrkĩ	 d ù r k ĩ |
kabë̀la	 k a b ë ̀ l a |
ñẽ́ẽ	 ñ ẽ ́ ẽ |
diö̀	 d i ö ̀ |
yèkètche	 y è k è t c h e |
shkö̀	 s h k ö ̀ |
tchër	 t c h ë r |
klö̀rke	 k l ö ̀ r k e |
mẽ̀ke	 m ẽ ̀ k e |
kkué	 k k u é |
tsṍwek	 t s õ ́ w e k |
tsṍ	 t s õ ́ |
ẽ̀rpa	 ẽ ̀ r p a |
abuelita	 a b u e l i t a |
aìse	 a ì s e |
dàtsẽ	 d à t s ẽ |
klö̀ũk	 k l ö ̀ ũ k |
klö̀wẽke	 k l ö ̀ w ẽ k e |
m	 m |
mã	 m ã |
wĩ̀ke	 w ĩ ̀ k e |
dkrò	 d k r ò |
kö̀yök	 k ö ̀ y ö k |
kë́kë	 k ë ́ k ë |
kö̀yànẽ	 k ö ̀ y à n ẽ |
iã	 i ã |
ulítãnẽ	 u l í t ã n ẽ |
sẽ́rãã	 s ẽ ́ r ã ã |
ah	 a h |
kuö̀wöla	 k u ö ̀ w ö l a |
wö̀k	 w ö ̀ k |
wẽ	 w ẽ |
́	 ́ |
mĩ̀ke	 m ĩ ̀ k e |
sĩõ'	 s ĩ õ ' |
e'la	 e ' l a |
tã	 t ã |
yuwö̀kbala	 y u w ö ̀ k b a l a |
s	 s |
klö̀wẽ	 k l ö ̀ w ẽ |
kuö̀	 k u ö ̀ |
mĩ̀r	 m ĩ ̀ r |
r	 r |
kĩ́ka	 k ĩ ́ k a |
klö̀nẽ	 k l ö ̀ n ẽ |
dékã	 d é k ã |
tchétökicha	 t c h é t ö k i c h a |
e'tã	 e ' t ã |
lònẽ	 l ò n ẽ |
"	 " |
dö̀kã	 d ö ̀ k ã |
ñẽ'	 ñ ẽ ' |
mĩr	 m ĩ r |
wẽ̀ke	 w ẽ ̀ k e |
klö̀nẽ̀tche	 k l ö ̀ n ẽ ̀ t c h e |
kkuè	 k k u è |
õ̀ne	 õ ̀ n e |
bàwẽ̀ke	 b à w ẽ ̀ k e |
ulé	 u l é |
ulàklö̀ũ̀ke	 u l à k l ö ̀ ũ ̀ k e |
kúshki	 k ú s h k i |
ñãtchèke	 ñ ã t c h è k e |
ímã	 í m ã |
yuwèke	 y u w è k e |
bala	 b a l a |
i'tã	 i ' t ã |
tté	 t t é |
chök	 c h ö k |
""be'	 " " b e ' |
jkuö́""	 j k u ö ́ " " |
o	 o |
rpáũ""	 r p á ũ " " |
yulö́""	 y u l ö ́ " " |
surùrù	 s u r ù r ù |
yulèke	 y u l è k e |
ãã	 ã ã |
lèke	 l è k e |
chũmũ̀	 c h ũ m ũ ̀ |
wö̀tchèke	 w ö ̀ t c h è k e |
kö̀yèke	 k ö ̀ y è k e |
ttèke	 t t è k e |
kõ̀r	 k õ ̀ r |
sẽ́	 s ẽ ́ |
""íñẽ	 " " í ñ ẽ |
tsṍlĩ	 t s õ ́ l ĩ |
ñe'	 ñ e ' |
rpánẽ	 r p á n ẽ |
kõ̀re	 k õ ̀ r e |
rpánẽtche	 r p á n ẽ t c h e |
dà	 d à |
tulèkèwã	 t u l è k è w ã |
kerèè	 k e r è è |
kàltákla	 k à l t á k l a |
tãmĩ́	 t ã m ĩ ́ |
tchèkèwã	 t c h è k è w ã |
tãmĩ́pa	 t ã m ĩ ́ p a |
bátsike	 b á t s i k e |
timĩ́	 t i m ĩ ́ |
kë́chikè	 k ë ́ c h i k è |
mĩk	 m ĩ k |
kabë̀lala	 k a b ë ̀ l a l a |
kĩ́kã	 k ĩ ́ k ã |
ñẽ́jkë	 ñ ẽ ́ j k ë |
chakàla	 c h a k a ̀ l a |
élkela	 é l k e l a |
lìnẽ	 l ì n ẽ |
dikótö	 d i k ó t ö |
chö́k	 c h ö ́ k |
kö̀ppèkèkãtche	 k ö ̀ p p è k è k ã t c h e |
ñẽ́ẽrö	 ñ ẽ ́ ẽ r ö |
ñẽ̀kũ̀wã	 ñ ẽ ̀ k ũ ̀ w ã |
mẽ̀nẽ	 m ẽ ̀ n ẽ |
ñẽ̀wã	 ñ ẽ ̀ w ã |
ñẽ̀ke	 ñ ẽ ̀ k e |
ñẽ̀kewã	 ñ ẽ ̀ k e w ã |
wö̀mãnẽ̀rke	 w ö ̀ m ã n ẽ ̀ r k e |
wĩ́kĩ	 w ĩ ́ k ĩ |
ĩõ̀kĩ	 ĩ õ ̀ k ĩ |
èka	 è k a |
mẽ̀kènẽ	 m ẽ ̀ k è n ẽ |
tsṍkuèke	 t s õ ́ k u è k e |
tás	 t á s |
éwa	 é w a |
ñèke	 ñ è k e |
wĩ̀	 w ĩ ̀ |
tso'tche	 t s o ' t c h e |
tamĩ́	 t a m ĩ ́ |
kãnẽ́	 k ã n ẽ ́ |
mũlépa	 m ũ l é p a |
ñã̀nẽ	 ñ ã ̀ n ẽ |
ès	 e ̀ s |
kõ̀rë	 k õ ̀ r ë |
sũwẽ̀ke	 s ũ w ẽ ̀ k e |
yö̀rkela	 y ö ̀ r k e l a |
sũwẽ̀	 s ũ w ẽ ̀ |
rñẽ̀ẽ̀	 r ñ ẽ ̀ ẽ ̀ |
bulé	 b u l é |
wö̀të̀nẽ	 w ö ̀ t ë ̀ n ẽ |
ãñĩ̀es	 ã ñ ĩ ̀ e s |
bitsö̀ke	 b i t s ö ̀ k e |
ñĩ̀ĩ̀	 ñ ĩ ̀ ĩ ̀ |
bulàmĩ	 b u l à m ĩ |
shkènẽ	 s h k è n ẽ |
bità	 b i t à |
ñẽ̀kènẽ	 ñ ẽ ̀ k è n ẽ |
yèke	 y è k e |
pònẽ̀mĩ	 p ò n ẽ ̀ m ĩ |
mĩ̀chò	 m ĩ ̀ c h ò |
kãñĩ́k	 k ã ñ ĩ ́ k |
mĩ̀tsẽ	 m ĩ ̀ t s ẽ |
che	 c h e |
""tchẽ́k	 " " t c h ẽ ́ k |
rö̀nẽ	 r ö ̀ n ẽ |
íẽ	 í ẽ |
ã""	 ã " " |
wĩ́ẽ	 w ĩ ́ ẽ |
chòò	 c h ò ò |
ár	 á r |
tök	 t ö k |
ṹ	 ũ ́ |
ppṍ	 p p õ ́ |
rpö̀	 r p ö ̀ |
tchök	 t c h ö k |
tchö̀k	 t c h ö ̀ k |
rpáwẽ̀ke	 r p á w ẽ ̀ k e |
kapö̀ke	 k a p ö ̀ k e |
kapë̀ule	 k a p ë ̀ u l e |
shõ̀õ̀	 s h õ ̀ õ ̀ |
dö̀nẽ	 d ö ̀ n ẽ |
tchẽ́k	 t c h ẽ ́ k |
dàtsĩkènẽ	 d à t s ĩ k è n ẽ |
yö̀kĩkã	 y ö ̀ k ĩ k ã |
ãwĩ̀ẽ	 ã w ĩ ̀ ẽ |
wẽ́shkẽ	 w ẽ ́ s h k ẽ |
rpáũk	 r p á ũ k |
chãmũ̀	 c h ã m ũ ̀ |
jkuök	 j k u ö k |
dàtsikènẽ	 d à t s i k è n ẽ |
jkuö̀k	 j k u ö ̀ k |
yóie	 y ó i e |
chö́kale	 c h ö ́ k a l e |
ése;	 é s e ; |
jkuö̀k;	 j k u ö ̀ k ; |
yök	 y ö k |
bánẽt	 b á n ẽ t |
yàmĩpa	 y à m ĩ p a |
balèke	 b a l è k e |
èmã	 è m ã |
mĩ̀nã	 m ĩ ̀ n ã |
kutápa	 k u t á p a |
wĩ̀kela	 w ĩ ̀ k e l a |
yèse	 y è s e |
tso'se	 t s o ' s e |
mĩ̀	 m ĩ ̀ |
mĩ̀nẽ	 m ĩ ̀ n ẽ |
nẽ'	 n ẽ ' |
kujkuö̀k	 k u j k u ö ̀ k |
dénẽ	 d é n ẽ |
tsuru'la	 t s u r u ' l a |
jkué	 j k u é |
sũ̀	 s ũ ̀ |
wã	 w ã |
bitẽ́	 b i t ẽ ́ |
wĩ̀ẽ	 w ĩ ̀ ẽ |
tsṍkö̀rkètchenẽ	 t s õ ́ k ö ̀ r k è t c h e n ẽ |
éẽ;	 é ẽ ; |
pàsiwẽ̀ke	 p à s i w ẽ ̀ k e |
síule	 s í u l e |
kṍkö̀ie	 k õ ́ k ö ̀ i e |
árie	 á r i e |
dàtsike	 d à t s i k e |
èwa	 è w a |
tsṍkuèkènẽ	 t s õ ́ k u è k è n ẽ |
íke	 í k e |
ñẽ̀ẽ	 ñ ẽ ̀ ẽ |
débitũ	 d é b i t ũ |
su	 s u |
mĩ̀tchènẽ	 m ĩ ̀ t c h è n ẽ |
tsṍwẽ	 t s õ ́ w ẽ |
mĩ́	 m ĩ ́ |
tkótö	 t k ó t ö |
blo'la	 b l o ' l a |
blòblòla	 b l ò b l ò l a |
yèkènẽ	 y è k è n ẽ |
pë'	 p ë ' |
yànẽ	 y à n ẽ |
iál	 i á l |
sulùũke	 s u l ù ũ k e |
ẽ́n	 ẽ ́ n |
sũwẽ́	 s ũ w ẽ ́ |
õ̀nẽ	 õ ̀ n ẽ |
sulùõ̀wã	 s u l ù õ ̀ w ã |
èkapë	 e ̀ k a p ë |
mẽ́wẽ̀wã	 m ẽ ́ w ẽ ̀ w ã |
èkëpë	 è k ë p ë |
èkapë	 è k a p ë |
mẽ́nẽwã;	 m ẽ ́ n ẽ w ã ; |
kũẽ́kĩ	 k ũ ẽ ́ k ĩ |
chaké	 c h a k é |
mẽ̀nẽ̀ãt	 m ẽ ̀ n ẽ ̀ ã t |
yö̀ie	 y ö ̀ i e |
bàtan	 b à t a n |
yulèkètche	 y u l è k è t c h e |
yulök	 y u l ö k |
iö́k	 i ö ́ k |
dë̀	 d ë ̀ |
natalia	 n a t a l i a |
kièke	 k i è k e |
ñũ	 ñ ũ |
wĩ'	 w ĩ ' |
émã	 é m ã |
kë́chike	 k ë ́ c h i k e |
mĩ̀ke;	 m ĩ ̀ k e ; |
juwé	 j u w é |
mj	 m j |
tchë́l	 t c h ë ́ l |
sã́ũ	 s ã ́ ũ |
mĩ̀tchela	 m ĩ ̀ t c h e l a |
kué	 k u é |
katèke	 k a t è k e |
kùnẽ	 k ù n ẽ |
mĩ̀k	 m ĩ ̀ k |
juwá	 j u w á |
ẽh	 ẽ h |
juwápa	 j u w á p a |
yàrke	 y à r k e |
noo!	 n o o ! |
èklala	 è k l a l a |
yànũk	 y à n ũ k |
tã;	 t ã ; |
kũẽ́k	 k ũ ẽ ́ k |
yö̀rketche	 y ö ̀ r k e t c h e |
yuwö̀k	 y u w ö ̀ k |
yö̀nẽ	 y ö ̀ n ẽ |
èkalala	 è k a l a l a |
yé	 y é |
kuli'	 k u l i ' |
ië̀nẽ̀wã	 i ë ̀ n ẽ ̀ w ã |
iènẽ̀wã	 i è n ẽ ̀ w ã |
'õnõ̀s	 ' õ n õ ̀ s |
ièke	 i è k e |
ièkèwã	 i è k è w ã |
bitũ̀ke	 b i t ũ ̀ k e |
kũẽ́	 k ũ ẽ ́ |
iõ̀iõ̀	 i õ ̀ i õ ̀ |
dùla	 d ù l a |
tso'iã	 t s o ' i ã |
sũlĩ̀	 s ũ l ĩ ̀ |
kàsir	 k à s i r |
kõnõ'	 k õ n õ ' |
kũẽ̀iã	 k ũ ẽ ̀ i ã |
tö;	 t ö ; |
sh	 s h |
choò	 c h o ò |
chìchila	 c h ì c h i l a |
wö̀balawẽ́	 w ö ̀ b a l a w ẽ ́ |
yë́balök	 y ë ́ b a l ö k |
iálpa	 i á l p a |
yö̀kĩ	 y ö ̀ k ĩ |
anstasia	 a n s t a s i a |
démĩ	 d é m ĩ |
tö̀tchèkètche	 t ö ̀ t c h è k è t c h e |
tö̀tchök	 t ö ̀ t c h ö k |
tö̀tchök;	 t ö ̀ t c h ö k ; |
tö̀tchèke	 t ö ̀ t c h è k e |
kũẽ̀mĩ	 k ũ ẽ ̀ m ĩ |
kanẽ̀wẽ̀ke	 k a n ẽ ̀ w ẽ ̀ k e |
ñõ̀wẽ̀ke	 ñ õ ̀ w ẽ ̀ k e |
wẽ̀ke;	 w ẽ ̀ k e ; |
wö̀balaũ̀tche	 w ö ̀ b a l a ũ ̀ t c h e |
yë́syë̀së	 y ë ́ s y ë ̀ s ë |
mũ̀kètsã	 m ũ ̀ k è t s ã |
wö̀balaũ̀ke	 w ö ̀ b a l a ũ ̀ k e |
bitsö̀kkã	 b i t s ö ̀ k k ã |
alàla	 a l à l a |
kãnẽ̀wẽ̀ke;	 k ã n ẽ ̀ w ẽ ̀ k e ; |
mĩ̀ka	 m ĩ ̀ k a |
diö̀yàrke	 d i ö ̀ y à r k e |
ñĩ̀	 ñ ĩ ̀ |
diö̀yö̀ke	 d i ö ̀ y ö ̀ k e |
ñĩ̀we	 ñ ĩ ̀ w e |
tsṍwe	 t s õ ́ w e |
pàkètcha	 p à k è t c h a |
ñã̀nẽ;	 ñ ã ̀ n ẽ ; |
kṍmĩ	 k õ ́ m ĩ |
yö̀wã	 y ö ̀ w ã |
ñũ̀wã	 ñ ũ ̀ w ã |
õ̀rtã	 õ ̀ r t ã |
chö́k;	 c h ö ́ k ; |
dolò	 d o l ò |
ë̀mẽ	 ë ̀ m ẽ |
póppòë	 p ó p p ò ë |
yènẽ	 y è n ẽ |
kũ	 k ũ |
tsṍyànẽ	 t s õ ́ y à n ẽ |
ni	 n i |
chö́pa	 c h ö ́ p a |
kë́chikéla	 k ë ́ c h i k é l a |
kë́chiképàtche	 k ë ́ c h i k é p à t c h e |
yàrkètche	 y à r k è t c h e |
mĩ́la	 m ĩ ́ l a |
kák	 k á k |
yë̀nẽ	 y ë ̀ n ẽ |
wákpala	 w á k p a l a |
mẽ̀wẽ̀kewã;	 m ẽ ̀ w ẽ ̀ k e w ã ; |
chétcha	 c h é t c h a |
sulù	 s u l ù |
mẽ̀wẽ	 m ẽ ̀ w ẽ |
mẽ̀wẽ̀wã	 m ẽ ̀ w ẽ ̀ w ã |
ñĩ̀es	 ñ ĩ ̀ e s |
emã	 e m ã |
kapö̀k	 k a p ö ̀ k |
chò	 c h ò |
ñẽ'tã	 ñ ẽ ' t ã |
kũẽkĩ	 k ũ ẽ k ĩ |
ùla	 ù l a |
yuwö̀ke	 y u w ö ̀ k e |
tchër;	 t c h ë r ; |
wèla	 w è l a |
ètökicha	 è t ö k i c h a |
shkök	 s h k ö k |
kẽ́ũk	 k ẽ ́ ũ k |
kuö̀kĩ	 k u ö ̀ k ĩ |
tã́iã	 t ã ́ i ã |
bitsèbita	 b i t s è b i t a |
mĩ̀nẽã	 m ĩ ̀ n ẽ ã |
m'm	 m ' m |
èttsinĩ	 è t t s i n ĩ |
ñẽ́es	 ñ ẽ ́ e s |
kölö̀wẽ	 k ö l ö ̀ w ẽ |
í	 í |
dapárke	 d a p á r k e |
ulàwa	 u l à w a |
wĩ̀es;	 w ĩ ̀ e s ; |
ulàwa;	 u l à w a ; |
mm	 m m |
mẽlẽ̀ã	 m ẽ l ẽ ̀ ã |
pàkök	 p à k ö k |
rpárke	 r p á r k e |
bítökicha	 b í t ö k i c h a |
tsṍyèke	 t s õ ́ y è k e |
bö̀tökicha	 b ö ̀ t ö k i c h a |
tchë́tokicha	 t c h ë ́ t o k i c h a |
kãnẽ̀wèke	 k ã n ẽ ̀ w è k e |
kẽ́wek	 k ẽ ́ w e k |
mẽnẽ̀wẽ̀ke	 m ẽ n ẽ ̀ w ẽ ̀ k e |
un	 u n |
poco	 p o c o |
kãnẽ̀wẽ	 k ã n ẽ ̀ w ẽ |
mĩchòë	 m ĩ c h ò ë |
kẽ́krà	 k ẽ ́ k r à |
dàtsikène	 d à t s i k è n e |
ri	 r i |
mĩ̀nẽ̀nẽ	 m ĩ ̀ n ẽ ̀ n ẽ |
a	 a |
tsṍtcha	 t s õ ́ t c h a |
sũ̀ë	 s ũ ̀ ë |
sĩõ'tãmĩpa	 s ĩ õ ' t ã m ĩ p a |
i'se	 i ' s e |
bitsé	 b i t s é |
darë̀rë̀	 d a r ë ̀ r ë ̀ |
tsé	 t s é |
bitàla	 b i t à l a |
yàrkenẽ	 y à r k e n ẽ |
kók	 k ó k |
pàkuèkenẽ	 p à k u è k e n ẽ |
aí	 a í |
kũẽ̀kèkã	 k ũ ẽ ̀ k è k ã |
wẽ̀	 w ẽ ̀ |
pàkuèke	 p à k u è k e |
shõ̀	 s h õ ̀ |
yë̀nũkã	 y ë ̀ n ũ k ã |
ichàkíule	 i c h à k í u l e |
ishtàwẽ̀mĩ	 i s h t à w ẽ ̀ m ĩ |
sobre	 s o b r e |
kãnẽ̀balö	 k ã n ẽ ̀ b a l ö |
mami	 m a m i |
ishtàwẽ́	 i s h t à w ẽ ́ |
tsë̀ë	 t s ë ̀ ë |
ãjã́	 ã j ã ́ |
ẽẽ	 ẽ ẽ |
wẽlè	 w ẽ l è |
yönẽ	 y ö n ẽ |
kibìie	 k i b ì i e |
ditséwöpa	 d i t s é w ö p a |
shũ̀shã̀	 s h ũ ̀ s h ã ̀ |
ie;	 i e ; |
dë́l	 d ë ́ l |
yë̀bitũ	 y ë ̀ b i t ũ |
mãnẽ̀te	 m ã n ẽ ̀ t e |
kuö̀wö	 k u ö ̀ w ö |
rö̀pakã	 r ö ̀ p a k ã |
kìnẽ	 k ì n ẽ |
káũk	 k á ũ k |
iõiõ̀	 i õ i õ ̀ |
tã́ĩ;	 t ã ́ ĩ ; |
kö̀iè	 k ö ̀ i è |
ar	 a r |
klö̀tsã	 k l ö ̀ t s ã |
dàtsĩ	 d à t s ĩ |
káwẽ́tsã	 k á w ẽ ́ t s ã |
mẽlẽ̀	 m ẽ l ẽ ̀ |
sũwõ'	 s ũ w õ ' |
suwõ'	 s u w õ ' |
kiètã́nẽ	 k i è t ã ́ n ẽ |
yö̀rtã	 y ö ̀ r t ã |
bua'ëmẽ	 b u a ' ë m ẽ |
mũ'	 m ũ ' |
ònẽ	 ò n ẽ |
ditsö̀pa	 d i t s ö ̀ p a |
bitsö̀rö	 b i t s ö ̀ r ö |
dö	 d ö |
lèkã	 l è k ã |
bua'ie	 b u a ' i e |
di	 d i |
dö̀ka	 d ö ̀ k a |
páiki	 p á i k i |
pedro	 p e d r o |
kṍjkẽ̀ẽ	 k õ ́ j k ẽ ̀ ẽ |
yuwák	 y u w á k |
suwànẽ	 s u w à n ẽ |
si	 s i |
yö̀rpa	 y ö ̀ r p a |
yö̀nṍk	 y ö ̀ n õ ́ k |
mĩ́ã	 m ĩ ́ ã |
sa	 s a |
kë́köl	 k ë ́ k ö l |
dö̀mĩ	 d ö ̀ m ĩ |
wéìnẽ	 w é ì n ẽ |
kacha'	 k a c h a ' |
tsũkmĩ	 t s ũ k m ĩ |
kkãmã'	 k k ã m ã ' |
wíbulu	 w í b u l u |
ulíulí	 u l í u l í |
shinõ̀nõ̀	 s h i n õ ̀ n õ ̀ |
tchërala	 t c h ë r a l a |
démĩpa	 d é m ĩ p a |
sklèla	 s k l è l a |
kö́ö	 k ö ́ ö |
""i	 " " i |
katànṍkwã""	 k a t à n õ ́ k w ã " " |
""se'	 " " s e ' |
katànõkwã""	 k a t à n õ k w ã " " |
añĩ̀	 a ñ ĩ ̀ |
dëlë̀r	 d ë l ë ̀ r |
tã́ĩ	 t ã ́ ĩ |
wö̀tö̀ke	 w ö ̀ t ö ̀ k e |
wö̀tö	 w ö ̀ t ö |
ièkã	 i è k ã |
caja	 c a j a |
tsṹmĩ	 t s ũ ́ m ĩ |
wö̀tö́wã	 w ö ̀ t ö ́ w ã |
dikó	 d i k ó |
bikèke	 b i k è k e |
ttö̀ke	 t t ö ̀ k e |
bikö̀ke	 b i k ö ̀ k e |
bikákla	 b i k á k l a |
nãmã̀bita	 n ã m ã ̀ b i t a |
bikö̀mĩ	 b i k ö ̀ m ĩ |
nãñẽ̀e	 n ã ñ ẽ ̀ e |
kã́ñĩ̀nẽ	 k ã ́ ñ ĩ ̀ n ẽ |
mĩ́tchèrak	 m ĩ ́ t c h è r a k |
wẽ́shkètche	 w ẽ ́ s h k è t c h e |
kièrak	 k i è r a k |
""wẽ́shkètche""	 " " w ẽ ́ s h k è t c h e " " |
batörö̀	 b a t ö r ö ̀ |
iõiõ̀ë	 i õ i õ ̀ ë |
mũlũ̀sik	 m ũ l ũ ̀ s i k |
éyök	 é y ö k |
tsa'	 t s a ' |
ták	 t á k |
mẽ̀kã	 m ẽ ̀ k ã |
suítö	 s u í t ö |
suíyö	 s u í y ö |
buèke	 b u è k e |
batsĩ̀	 b a t s ĩ ̀ |
rak	 r a k |
""suítö""	 " " s u í t ö " " |
imã	 i m ã |
nãmã̀bitala	 n ã m ã ̀ b i t a l a |
suí	 s u í |
yàrketche	 y à r k e t c h e |
kulé	 k u l é |
mẽ̀wã	 m ẽ ̀ w ã |
wö̀nĩka	 w ö ̀ n ĩ k a |
ĩ́shẽla	 ĩ ́ s h ẽ l a |
õ̀mĩk	 õ ̀ m ĩ k |
diö́shẽt	 d i ö ́ s h ẽ t |
tchèwã	 t c h è w ã |
aìshẽt	 a ì s h ẽ t |
èköl	 è k ö l |
shũshõ̀	 s h ũ s h õ ̀ |
tchèsẽ	 t c h è s ẽ |
mũlũ̀	 m ũ l ũ ̀ |
tsurúi	 t s u r ú i |
dàtsikètche	 d à t s i k è t c h e |
mẽ̀	 m ẽ ̀ |
kula'	 k u l a ' |
wíñõk	 w í ñ õ k |
èt	 è t |
àtsĩ	 à t s ĩ |
wö̀mãnẽ̀wẽ̀nẽ	 w ö ̀ m ã n ẽ ̀ w ẽ ̀ n ẽ |
wö̀mãnẽ̀wẽ̀ke	 w ö ̀ m ã n ẽ ̀ w ẽ ̀ k e |
wì	 w ì |
àtsẽ	 à t s ẽ |
aìëkã	 a ì ë k ã |
aìẽ	 a ì ẽ |
tsã́	 t s ã ́ |
tékã	 t é k ã |
tsìr	 t s ì r |
bulùbulùë	 b u l ù b u l ù ë |
islẽ́mã	 i s l ẽ ́ m ã |
wö̀mãnẽ̀rkètche	 w ö ̀ m ã n ẽ ̀ r k è t c h e |
mĩkã	 m ĩ k ã |
kë́kölö	 k ë ́ k ö l ö |
katö́	 k a t ö ́ |
chakö́	 c h a k ö ́ |
chakè	 c h a k è |
ñã́	 ñ ã ́ |
otro	 o t r o |
wẽmbrö	 w ẽ m b r ö |
tulur	 t u l u r |
chakö̀	 c h a k ö ̀ |
chakö̀ke	 c h a k ö ̀ k e |
skuée	 s k u é e |
kuö́kĩ	 k u ö ́ k ĩ |
mĩ́tsẽ̀wã	 m ĩ ́ t s ẽ ̀ w ã |
wë́tsë	 w ë ́ t s ë |
mẽ̀mĩ́tsẽ	 m ẽ ̀ m ĩ ́ t s ẽ |
shuwèkèwã	 s h u w è k è w ã |
mẽ̀kèwã	 m ẽ ̀ k è w ã |
ĩ́skĩ	 ĩ ́ s k ĩ |
klö̀ũkwã	 k l ö ̀ ũ k w ã |
klö̀wẽ̀wã	 k l ö ̀ w ẽ ̀ w ã |
íẽrö	 í ẽ r ö |
kö́kã""	 k ö ́ k ã " " |
íes	 í e s |
kö́kã	 k ö ́ k ã |
mṹwã	 m ũ ́ w ã |
diàë́ka	 d i à ë ́ k a |
mẽ́wã	 m ẽ ́ w ã |
suíyök	 s u í y ö k |
rrátkèwãtche	 r r á t k è w ã t c h e |
õ'	 õ ' |
mũẽ̀kèwã	 m ũ ẽ ̀ k è w ã |
sirö̀tak	 s i r ö ̀ t a k |
kàlkicha'	 k à l k i c h a ' |
tsa'kicha'	 t s a ' k i c h a ' |
wíbulula	 w í b u l u l a |
mĩchò	 m ĩ c h ò |
diö́köl	 d i ö ́ k ö l |
tabè	 t a b è |
mẽ̀nẽ̀wa	 m ẽ ̀ n ẽ ̀ w a |
tö̀kĩ	 t ö ̀ k ĩ |
kö́iéulewã	 k ö ́ i é u l e w ã |
kaléũ̀	 k a l é ũ ̀ |
bë́rbëla	 b ë ́ r b ë l a |
kalétsã	 k a l é t s ã |
aísũ	 a í s ũ |
chèkã	 c h è k ã |
kë́chike""	 k ë ́ c h i k e " " |
bitsi'	 b i t s i ' |
kö̀ppée	 k ö ̀ p p é e |
shõ̀ë̀mẽ	 s h õ ̀ ë ̀ m ẽ |
swĩ̀mĩ	 s w ĩ ̀ m ĩ |
kë̀wë̀kala	 k ë ̀ w ë ̀ k a l a |
mẽ́kã	 m ẽ ́ k ã |
tuèke	 t u è k e |
tã́ĩë	 t ã ́ ĩ ë |
kã́wötã	 k ã ́ w ö t ã |
bë̀rëmẽ	 b ë ̀ r ë m ẽ |
yö̀tsã	 y ö ̀ t s ã |
yë́tsã	 y ë ́ t s ã |
kañĩ́kã	 k a ñ ĩ ́ k ã |
iànẽ	 i à n ẽ |
mũẽ̀	 m ũ ẽ ̀ |
batũrèwã	 b a t ũ r è w ã |
tchátche	 t c h á t c h e |
bë̀rë	 b ë ̀ r ë |
ñãlã̀	 ñ ã l ã ̀ |
jkö̀	 j k ö ̀ |
tchörö	 t c h ö r ö |
mẽ̀rkèkã	 m ẽ ̀ r k è k ã |
katà	 k a t à |
balë̀rkètche	 b a l ë ̀ r k è t c h e |
skèkèwã	 s k è k è w ã |
mẽ̀kèiã̀nẽ	 m ẽ ̀ k è i ã ̀ n ẽ |
otra	 o t r a |
wàbale	 w à b a l e |
dë̀dë	 d ë ̀ d ë |
wĩ́ẽrö	 w ĩ ́ ẽ r ö |
baterèwãmĩ	 b a t e r è w ã m ĩ |
dínẽiã	 d í n ẽ i ã |
ulàmẽ̀ule	 u l à m ẽ ̀ u l e |
shkẽ̀rkèkãnẽ	 s h k ẽ ̀ r k è k ã n ẽ |
dalë̀r	 d a l ë ̀ r |
kãnẽ̀wẽ̀ketsã	 k ã n ẽ ̀ w ẽ ̀ k e t s ã |
ã̀s	 ã ̀ s |
ókömpa	 ó k ö m p a |
kë́chikepa	 k ë ́ c h i k e p a |
wĩ́ẽrö;	 w ĩ ́ ẽ r ö ; |
mũk	 m ũ k |
iö̀kwã	 i ö ̀ k w ã |
törö̀kwã	 t ö r ö ̀ k w ã |
teréwã	 t e r é w ã |
balök	 b a l ö k |
ishkẽ̀rkèkã	 i s h k ẽ ̀ r k è k ã |
mẽ́ule	 m ẽ ́ u l e |
iõ̀	 i õ ̀ |
alàralar	 a l à r a l a r |
yö̀nẽbitũ	 y ö ̀ n ẽ b i t ũ |
yu	 y u |
bité	 b i t é |
teré	 t e r é |
wötö́kwã	 w ö t ö ́ k w ã |
ĩ́yök	 ĩ ́ y ö k |
kã́jkẽ	 k ã ́ j k ẽ |
balö̀rö	 b a l ö ̀ r ö |
kã'	 k ã ' |
tèke	 t è k e |
mẽr	 m ẽ r |
kuè	 k u è |
õ̀mĩkã	 õ ̀ m ĩ k ã |
kuèkèwã	 k u è k è w ã |
wanẽ	 w a n ẽ |
tchéwã	 t c h é w ã |
wö̀stéwã	 w ö ̀ s t é w ã |
tká	 t k á |
mĩchö̀ë	 m ĩ c h ö ̀ ë |
ukuö̀k	 u k u ö ̀ k |
ukuè	 u k u è |
kö̀nẽ	 k ö ̀ n ẽ |
skìnẽ	 s k ì n ẽ |
kàlka	 k à l k a |
wö̀nẽ́	 w ö ̀ n ẽ ́ |
tsã̀	 t s ã ̀ |
biökè	 b i ö k è |
kànẽ	 k à n ẽ |
bë́rbër	 b ë ́ r b ë r |
rñẽ́we	 r ñ ẽ ́ w e |
kṍ	 k õ ́ |
ukuö́ũk	 u k u ö ́ ũ k |
wĩ́	 w ĩ ́ |
mĩ̀kèwã	 m ĩ ̀ k è w ã |
kã́	 k ã ́ |
shũshõ̀ë	 s h ũ s h õ ̀ ë |
bö'wö	 b ö ' w ö |
énũĩ̀	 é n ũ ĩ ̀ |
yë́wöla	 y ë ́ w ö l a |
por	 p o r |
eso	 e s o |
ë́l	 ë ́ l |
kuàt	 k u à t |
tché	 t c h é |
lista	 l i s t a |
shũshõ̀la	 s h ũ s h õ ̀ l a |
pákètche	 p á k è t c h e |
mĩ́tche	 m ĩ ́ t c h e |
ukuö́k	 u k u ö ́ k |
làri	 l à r i |
rpànẽ	 r p à n ẽ |
skuè	 s k u è |
ẽ̀nẽ̀wã	 ẽ ̀ n ẽ ̀ w ã |
ã;	 ã ; |
ba	 b a |
bánẽ	 b á n ẽ |
nãñẽ́we	 n ã ñ ẽ ́ w e |
tërkènẽ	 t ë r k è n ẽ |
kapö̀kwã	 k a p ö ̀ k w ã |
tchë́nĩk	 t c h ë ́ n ĩ k |
tchabàtchabàëmẽ	 t c h a b à t c h a b à ë m ẽ |
tsṍli	 t s õ ́ l i |
íe	 í e |
mũẽ̀wã	 m ũ ẽ ̀ w ã |
étchö	 é t c h ö |
ppéũ	 p p é ũ |
chip	 c h i p |
akuö̀k	 a k u ö ̀ k |
wö̀yètse	 w ö ̀ y è t s e |
bulámĩ	 b u l á m ĩ |
akuök	 a k u ö k |
di'bitàã	 d i ' b i t à ã |
tsã́lĩ	 t s ã ́ l ĩ |
akuö̀wẽ̀kenẽ	 a k u ö ̀ w ẽ ̀ k e n ẽ |
bö́iki	 b ö ́ i k i |
mĩtche	 m ĩ t c h e |
mũlũ̀nẽ	 m ũ l ũ ̀ n ẽ |
bë̀rbë̀rala	 b ë ̀ r b ë ̀ r a l a |
wö̀tsée	 w ö ̀ t s é e |
yétsã	 y é t s ã |
nĩẽ́ẽ	 n ĩ ẽ ́ ẽ |
biè	 b i è |
péũ	 p é ũ |
ñẽ̀	 ñ ẽ ̀ |
kèmĩ	 k è m ĩ |
chakö̀mĩ	 c h a k ö ̀ m ĩ |
pẽ́kèwã	 p ẽ ́ k è w ã |
wö̀pẽ́	 w ö ̀ p ẽ ́ |
dulë́dulë	 d u l ë ́ d u l ë |
kuèke	 k u è k e |
bë̀r	 b ë ̀ r |
pòjpò	 p ò j p ò |
õ̀nẽ̀wã	 õ ̀ n ẽ ̀ w ã |
terèwã	 t e r è w ã |
terèkèwã	 t e r è k è w ã |
lbòla	 l b ò l a |
pàterèwãmĩ	 p à t e r è w ã m ĩ |
wa'	 w a ' |
amũ	 a m ũ |
wákapa	 w á k a p a |
bitsö̀	 b i t s ö ̀ |
tã́ĩëmẽ	 t ã ́ ĩ ë m ẽ |
shũ̀	 s h ũ ̀ |
dalë̀rke	 d a l ë ̀ r k e |
sulìsulìla	 s u l ì s u l ì l a |
mmm	 m m m |
ũ̀	 ũ ̀ |
ë̀ka	 ë ̀ k a |
kibì	 k i b ì |
m'm'	 m ' m ' |
aunque	 a u n q u e |
duwö̀mĩ	 d u w ö ̀ m ĩ |
siõ̀rë	 s i õ ̀ r ë |
dalë̀rwã	 d a l ë ̀ r w ã |
ñẽ́rö	 ñ ẽ ́ r ö |
lbó	 l b ó |
yö̀ke	 y ö ̀ k e |
síki	 s í k i |
tchá	 t c h á |
bitséitsè	 b i t s é i t s è |
mĩ́chö̀	 m ĩ ́ c h ö ̀ |
bitsétchö	 b i t s é t c h ö |
páké	 p á k é |
tchátsã	 t c h á t s ã |
ajkuö̀	 a j k u ö ̀ |
klö̀r	 k l ö ̀ r |
klö̀r;	 k l ö ̀ r ; |
ajkuö̀mĩ́tsẽ	 a j k u ö ̀ m ĩ ́ t s ẽ |
pàkö̀rke	 p à k ö ̀ r k e |
pàkuö̀kñã	 p à k u ö ̀ k ñ ã |
wéikèkètche	 w é i k è k è t c h e |
b	 b |
wéikè	 w é i k è |
iö̀kã	 i ö ̀ k ã |
""b	 " " b |
wéikeráwã	 w é i k e r á w ã |
siõ̀dala""	 s i õ ̀ d a l a " " |
wẽ́jkë	 w ẽ ́ j k ë |
siõ̀dala	 s i õ ̀ d a l a |
kũ̀nẽiã""	 k ũ ̀ n ẽ i ã " " |
ñẽ	 ñ ẽ |
kẽ́	 k ẽ ́ |
ñĩ̀ṹknẽ	 ñ ĩ ̀ ũ ́ k n ẽ |
""ẽ'	 " " ẽ ' |
ñĩ̀ṹknẽ""	 ñ ĩ ̀ ũ ́ k n ẽ " " |
pàkuö̀knẽ	 p à k u ö ̀ k n ẽ |
kãñĩ́kã	 k ã ñ ĩ ́ k ã |
wẽ́rö	 w ẽ ́ r ö |
durnẽ	 d u r n ẽ |
kö̀nã̀rpa	 k ö ̀ n ã ̀ r p a |
rà	 r à |
kuö̀mĩ̀nẽ	 k u ö ̀ m ĩ ̀ n ẽ |
pàkö̀nãrmĩ	 p à k ö ̀ n ã r m ĩ |
réwã	 r é w ã |
butùbutùë	 b u t ù b u t ù ë |
kö̀nã̀nẽwã	 k ö ̀ n ã ̀ n ẽ w ã |
kabë̀lapa	 k a b ë ̀ l a p a |
sĩõ̀rë	 s ĩ õ ̀ r ë |
rwö̀	 r w ö ̀ |
tẽr	 t ẽ r |
""kabë̀la	 " " k a b ë ̀ l a |
kṍchök	 k õ ́ c h ö k |
tã""	 t ã " " |
tsìrë	 t s ì r ë |
kuö̀ráã	 k u ö ̀ r á ã |
shkẽ̀rpàkã	 s h k ẽ ̀ r p a ̀ k ã |
mĩ́kã	 m ĩ ́ k ã |
tsö́	 t s ö ́ |
nṹnũ	 n ũ ́ n ũ |
""sítala	 " " s í t a l a |
kobòtala""	 k o b ò t a l a " " |
kö̀rmĩtsẽ	 k ö ̀ r m ĩ t s ẽ |
kö̀rke	 k ö ̀ r k e |
ie'la	 i e ' l a |
ẽ́rdiàrtã	 ẽ ́ r d i à r t ã |
wẽ́ikë	 w ẽ ́ i k ë |
ékapë	 é k a p ë |
""chu	 " " c h u |
kuö́ũ	 k u ö ́ ũ |
ë̀mẽ""	 ë ̀ m ẽ " " |
""tsuru'	 " " t s u r u ' |
klö̀ṹ	 k l ö ̀ ũ ́ |
ñã	 ñ ã |
pàchö̀	 p à c h ö ̀ |
kàlwák	 k à l w á k |
chẽ̀r	 c h ẽ ̀ r |
ã•	 ã • |
tsë̀r	 t s ë ̀ r |
bua'ëtche	 b u a ' ë t c h e |
bitsè	 b i t s è |
kölö́m	 k ö l ö ́ m |
ñẽ̀kũ	 ñ ẽ ̀ k ũ |
ulìtẽnẽ	 u l ì t ẽ n ẽ |
bitsö̀keiã	 b i t s ö ̀ k e i ã |
tchö̀kã	 t c h ö ̀ k ã |
wö̀chika	 w ö ̀ c h i k a |
kàlkuö	 k à l k u ö |
tchékã	 t c h é k ã |
kékã	 k é k ã |
sĩõ̀dala	 s ĩ õ ̀ d a l a |
kĩ́jkẽ	 k ĩ ́ j k ẽ |
ré	 r é |
kë́buklupa	 k ë ́ b u k l u p a |
kièrö	 k i è r ö |
""talàwak""	 " " t a l à w a k " " |
talàwak	 t a l à w a k |
talà	 t a l à |
akë́köl	 a k ë ́ k ö l |
mẽ̀nĩ	 m ẽ ̀ n ĩ |
sulé	 s u l é |
kṍska	 k õ ́ s k a |
diã̀ërö	 d i ã ̀ ë r ö |
rö̀pàkã	 r ö ̀ p a ̀ k ã |
kàchök	 k à c h ö k |
sṹ	 s ũ ́ |
""idèala""	 " " i d è a l a " " |
pàtcháka	 p à t c h á k a |
sũ̀nṍkie	 s ũ ̀ n õ ́ k i e |
pàkë	 p à k ë |
mẽnẽ́t	 m ẽ n ẽ ́ t |
wàbalè	 w à b a l è |
diàẽrö	 d i à ẽ r ö |
wàbalë'	 w à b a l ë ' |
dùwã	 d ù w ã |
nũ̀	 n ũ ̀ |
balë'	 b a l ë ' |
kalö̀õ'	 k a l ö ̀ õ ' |
wẽ̀jkë	 w ẽ ̀ j k ë |
pàtchékã	 p à t c h é k ã |
kũ̀nẽ	 k ũ ̀ n ẽ |
yuwö̀ráã	 y u w ö ̀ r á ã |
rö̀pàkã	 r ö ̀ p à k ã |
idèala	 i d è a l a |
sũ̀nṍk	 s ũ ̀ n õ ́ k |
""sã́ũ	 " " s ã ́ ũ |
durkã""	 d u r k ã " " |
deṹtũ	 d e ũ ́ t ũ |
chiroles	 c h i r o l e s |
tsirìwẽ	 t s i r ì w ẽ |
sẽ́es	 s ẽ ́ e s |
ñẽ̀mĩ	 ñ ẽ ̀ m ĩ |
wéìkö̀ke	 w é ì k ö ̀ k e |
bitsèke	 b i t s è k e |
ahhh	 a h h h |
ujkuèke	 u j k u è k e |
dë̀wã	 d ë ̀ w ã |
ó	 ó |
bitséitsèke	 b i t s é i t s è k e |
ocho	 o c h o |
días	 d í a s |
kàlwö	 k à l w ö |
falta	 f a l t a |
tse	 t s e |
seis	 s e i s |
año	 a ñ o |
kukuö̀ñã	 k u k u ö ̀ ñ ã |
tóto	 t ó t o |
wö́ki	 w ö ́ k i |
diez	 d i e z |
ẽ́r	 ẽ ́ r |
bulùbulùpa	 b u l ù b u l ù p a |
röawá	 r ö a w á |
kalö̀wẽ	 k a l ö ̀ w ẽ |
làrlàrpa	 l à r l à r p a |
èse	 è s e |
iũ̀te	 i ũ ̀ t e |
chénẽ	 c h é n ẽ |
chàkè	 c h à k è |
dónẽ	 d ó n ẽ |
lònẽ;	 l ò n ẽ ; |
papá	 p a p á |
nṹ	 n ũ ́ |
más	 m á s |
seguro	 s e g u r o |
yë́syë̀se	 y ë ́ s y ë ̀ s e |
awápa	 a w á p a |
tãiã;	 t ã i ã ; |
talamanca	 t a l a m a n c a |
iẽ	 i ẽ |
ulìtãnẽ	 u l ì t ã n ẽ |
aja	 a j a |
nãñẽ̀we	 n ã ñ ẽ ̀ w e |
jĩñẽ́itsök	 j ĩ ñ ẽ ́ i t s ö k |
ínẽ	 í n ẽ |
alàr	 a l à r |
lè	 l è |
dóã	 d ó ã |
ttö́dàã	 t t ö ́ d à ã |
brö̀	 b r ö ̀ |
yo	 y o |
sé	 s é |
yö̀nẽ!	 y ö ̀ n ẽ ! |
ja	 j a |
ja…)	 j a … ) |
narciso	 n a r c i s o |
mo	 m o |
morales	 m o r a l e s |
kachìi	 k a c h ì i |
tö̀	 t ö ̀ |
kãnẽ̀balötke	 k ã n ẽ ̀ b a l ö t k e |
duwa'	 d u w a ' |
détsẽ	 d é t s ẽ |
íẽka	 í ẽ k a |
kũẽ́wã	 k ũ ẽ ́ w ã |
lolo	 l o l o |
guabito;	 g u a b i t o ; |
chàke	 c h à k e |
kálök	 k á l ö k |
sulùnẽ̀kã	 s u l ù n ẽ ̀ k ã |
ñẽ'ẽ'	 ñ ẽ ' ẽ ' |
wö̀blaũk	 w ö ̀ b l a ũ k |
ñĩ̀jkë́ë	 ñ ĩ ̀ j k ë ́ ë |
wakè	 w a k è |
kö́nẽ̀ke	 k ö ́ n ẽ ̀ k e |
yö̀rpaiã	 y ö ̀ r p a i ã |
yö̀rmĩĩã	 y ö ̀ r m ĩ ĩ ã |
cara	 c a r a |
i'dë	 i ' d ë |
yö̀nẽĩã	 y ö ̀ n ẽ ĩ ã |
chö̀k	 c h ö ̀ k |
shkál	 s h k á l |
de	 d e |
mayor	 m a y o r |
tãiã	 t ã i ã |
nã́ũyö	 n ã ́ ũ y ö |
dë̀bitũ	 d ë ̀ b i t ũ |
dë̀tsẽ	 d ë ̀ t s ẽ |
tiene	 t i e n e |
cinco	 c i n c o |
años	 a ñ o s |
diàẽ	 d i à ẽ |
uloyo	 u l o y o |
dawö̀chkela	 d a w ö ̀ c h k e l a |
tṹsula	 t ũ ́ s u l a |
dawö̀chke	 d a w ö ̀ c h k e |
narberto	 n a r b e r t o |
dë́ũtu	 d ë ́ ũ t u |
chörà	 c h ö r à |
diö́ẽ	 d i ö ́ ẽ |
chöràla	 c h ö r à l a |
õ̀tẽ	 õ ̀ t ẽ |
shṍböts	 s h õ ́ b ö t s |
mõ̀rmĩ̀nẽ	 m õ ̀ r m ĩ ̀ n ẽ |
dursẽ	 d u r s ẽ |
cuatro	 c u a t r o |
kë́képa	 k ë ́ k é p a |
yuwö̀	 y u w ö ̀ |
iõ̀ka	 i õ ̀ k a |
chakìkã	 c h a k ì k ã |
e'tã;	 e ' t ã ; |
kö̀ök	 k ö ̀ ö k |
sulùsi	 s u l ù s i |
usáwõk	 u s á w õ k |
alàrke	 a l à r k e |
tsök	 t s ö k |
tsèke	 t s è k e |
bikéitsök	 b i k é i t s ö k |
bö́tökicha	 b ö ́ t ö k i c h a |
dalër	 d a l ë r |
kũiã	 k ũ i ã |
wẽ́se	 w ẽ ́ s e |
balo'	 b a l o ' |
kö̀öie	 k ö ̀ ö i e |
láköl	 l á k ö l |
kũṍkĩ	 k ũ õ ́ k ĩ |
bë̀remẽ	 b ë ̀ r e m ẽ |
kĩ́tsèkũ	 k ĩ ́ t s è k ũ |
ètch	 è t c h |
kë̀këpa	 k ë ̀ k ë p a |
mṍũk	 m õ ́ ũ k |
kukuö̀	 k u k u ö ̀ |
mĩ́ãnẽ	 m ĩ ́ ã n ẽ |
""ie'pa	 " " i e ' p a |
kö̀ö	 k ö ̀ ö |
ie'pa""	 i e ' p a " " |
chakì	 c h a k ì |
pàka	 p à k a |
wĩ́kka	 w ĩ ́ k k a |
""ñẽ'	 " " ñ ẽ ' |
mṍũk""	 m õ ́ ũ k " " |
irö́mĩyal	 i r ö ́ m ĩ y a l |
wĩ́es	 w ĩ ́ e s |
mj!	 m j ! |
pë'busi	 p ë ' b u s i |
bë̀riebulu	 b ë ̀ r i e b u l u |
wë́bi	 w ë ́ b i |
sabìr	 s a b ì r |
sulùëmẽ	 s u l ù ë m ẽ |
wèikö̀ke	 w è i k ö ̀ k e |
bikéitsèke	 b i k é i t s è k e |
islèmã	 i s l è m ã |
õ̀rmĩ	 õ ̀ r m ĩ |
bë̀rë;	 b ë ̀ r ë ; |
kùkùnẽ	 k ù k ù n ẽ |
kã́pàkök	 k ã ́ p à k ö k |
suwẽ̀	 s u w ẽ ̀ |
kĩ́tsök	 k ĩ ́ t s ö k |
ë̀k	 ë ̀ k |
chö́	 c h ö ́ |
""ñẽ́es	 " " ñ ẽ ́ e s |
tchërkã	 t c h ë r k ã |
ché""	 c h é " " |
duwè	 d u w è |
ese	 e s e |
kĩ́tsö́	 k ĩ ́ t s ö ́ |
lànẽ	 l à n ẽ |
énũĩ	 é n ũ ĩ |
aahh	 a a h h |
páùtke	 p á ù t k e |
duwás	 d u w á s |
diö̀yànẽ	 d i ö ̀ y à n ẽ |
sku'	 s k u ' |
yawök	 y a w ö k |
ètcha	 è t c h a |
tsìdalala	 t s ì d a l a l a |
ákwö	 á k w ö |
iówã	 i ó w ã |
kichà	 k i c h à |
tsìdala	 t s ì d a l a |
ièka	 i è k a |
tã́nkle	 t ã ́ n k l e |
tsã́tèwã	 t s ã ́ t è w ã |
tsã́te	 t s ã ́ t e |
está	 e s t á |
dalèwã	 d a l è w ã |
íkke	 í k k e |
ya'	 y a ' |
kañĩ́k	 k a ñ ĩ ́ k |
sùnẽ	 s ù n ẽ |
dö̀wãmĩ	 d ö ̀ w ã m ĩ |
dö̀tã	 d ö ̀ t ã |
momento	 m o m e n t o |
tchõ'	 t c h õ ' |
""ísã	 " " í s ã |
kapi""	 k a p i " " |
kapi	 k a p i |
dikóchka	 d i k ó c h k a |
ilèe	 i l è e |
iõ̀kĩ	 i õ ̀ k ĩ |
tchã'	 t c h ã ' |
chö́wẽ̀kèwã	 c h ö ́ w ẽ ̀ k è w ã |
kabènẽ	 k a b è n ẽ |
""s	 " " s |
kë́köl""	 k ë ́ k ö l " " |
dé;	 d é ; |
tsṍlĩkö	 t s õ ́ l ĩ k ö |
dakrò	 d a k r ò |
sarùrù	 s a r ù r ù |
lèkètche	 l è k è t c h e |
kukuèke	 k u k u è k e |
wõwṍnẽla	 w õ w õ ́ n ẽ l a |
bàwẽ	 b à w ẽ |
rñẽ́wẽ	 r ñ ẽ ́ w ẽ |
íkkëtã	 í k k ë t ã |
wö̀të́nẽwã	 w ö ̀ t ë ́ n ẽ w ã |
nãñẽ́wekö	 n ã ñ ẽ ́ w e k ö |
ñĩ́wek	 ñ ĩ ́ w e k |
kë́wë	 k ë ́ w ë |
balë̀nẽ̀wã	 b a l ë ̀ n ẽ ̀ w ã |
nãmã́söl	 n ã m ã ́ s ö l |
yi	 y i |
aláralar	 a l á r a l a r |
dó	 d ó |
tsũk	 t s ũ k |
dá	 d á |
mẽ́	 m ẽ ́ |
yànẽtche	 y à n ẽ t c h e |
yúshka	 y ú s h k a |
bayö̀balö́	 b a y ö ̀ b a l ö ́ |
e'ã	 e ' ã |
kèrwa	 k è r w a |
wébalè	 w é b a l è |
""i'	 " " i ' |
si'	 s i ' |
kã́ñĩ̀nẽ""	 k ã ́ ñ ĩ ̀ n ẽ " " |
wö̀mũ̀ke	 w ö ̀ m ũ ̀ k e |
wö̀mũkèwã""	 w ö ̀ m ũ k è w ã " " |
rpágala	 r p á g a l a |
chàké	 c h à k é |
wë̀nẽ	 w ë ̀ n ẽ |
bö̀t	 b ö ̀ t |
mãñã̀t	 m ã ñ ã ̀ t |
kã́ñìrke""	 k ã ́ ñ ì r k e " " |
wa;	 w a ; |
èk	 è k |
dö̀ppa	 d ö ̀ p p a |
wö̀mũkèwã	 w ö ̀ m ũ k e ̀ w ã |
sĩõ	 s ĩ õ |
'	 ' |
kalö̀nẽ	 k a l ö ̀ n ẽ |
bua'nẽiãnẽ	 b u a ' n ẽ i ã n ẽ |
yulë́la	 y u l ë ́ l a |
bua'rmĩnẽ	 b u a ' r m ĩ n ẽ |
bua'rdànẽ	 b u a ' r d à n ẽ |
rö;	 r ö ; |
kã́bata	 k ã ́ b a t a |
sĩ	 s ĩ |
bayö̀balé	 b a y ö ̀ b a l é |
tö̀kkã	 t ö ̀ k k ã |
tö̀tché	 t ö ̀ t c h é |
tétsã	 t é t s ã |
una	 u n a |
uuu	 u u u |
íjketã	 í j k e t ã |
wö̀të̀nẽtche	 w ö ̀ t ë ̀ n ẽ t c h e |
ẽ̀nĩõõ	 ẽ ̀ n ĩ õ õ |
wö̀të̀nẽwã	 w ö ̀ t ë ̀ n ẽ w ã |
kö̀ièwã	 k ö ̀ i è w ã |
chamũ̀	 c h a m ũ ̀ |
mĩ	 m ĩ |
sũ̀nẽ	 s ũ ̀ n ẽ |
wö̀uk	 w ö ̀ u k |
tsẽ̀keãt	 t s ẽ ̀ k e ã t |
kṍkö	 k õ ́ k ö |
tskurík	 t s k u r í k |
tṍ	 t õ ́ |
mẽrkã	 m ẽ r k ã |
diàse	 d i à s e |
kuwö̀̀	 k u w ö ̀ ̀ |
kuwö̀	 k u w ö ̀ |
lö́lö	 l ö ́ l ö |
kuö̀ë	 k u ö ̀ ë |
bö́	 b ö ́ |
jkö	 j k ö |
ñã́wẽ̀kètche	 ñ ã ́ w ẽ ̀ k è t c h e |
wö̀teulewã	 w ö ̀ t e u l e w ã |
tsĩ̀	 t s ĩ ̀ |
tak	 t a k |
ñã́wẽ̀ke	 ñ ã ́ w ẽ ̀ k e |
bukula'	 b u k u l a ' |
ùjkuö	 ù j k u ö |
èkapë;	 è k a p ë ; |
dalë̀nẽ	 d a l ë ̀ n ẽ |
yulèk	 y u l è k |
e	 e |
yölö̀nṍk	 y ö l ö ̀ n õ ́ k |
kapö̀	 k a p ö ̀ |
dölö̀	 d ö l ö ̀ |
bitsö̀mĩ	 b i t s ö ̀ m ĩ |
ñĩ̀ĩ̀ĩ̀	 ñ ĩ ̀ ĩ ̀ ĩ ̀ |
ppèkènẽ	 p p è k è n ẽ |
ma	 m a |
tũ̀m	 t ũ ̀ m |
kata'	 k a t a ' |
bikèwã	 b i k è w ã |
mũ̀	 m ũ ̀ |
kukõ'	 k u k õ ' |
pṹ	 p ũ ́ |
tsã́téwã	 t s ã ́ t é w ã |
íjkëla	 í j k ë l a |
íjkela;	 í j k e l a ; |
iékã	 i é k ã |
pèkènẽ	 p è k è n ẽ |
tsĩ	 t s ĩ |
skli	 s k l i |
tsã́kuée	 t s ã ́ k u é e |
bitsö̀wẽ̀ke	 b i t s ö ̀ w ẽ ̀ k e |
ñĩ̀ë	 ñ ĩ ̀ ë |
diö̀yö	 d i ö ̀ y ö |
suu	 s u u |
chö́kela	 c h ö ́ k e l a |
wö̀tërulèwã	 w ö ̀ t ë r u l è w ã |
distéwö	 d i s t é w ö |
íjketcha	 í j k e t c h a |
etch	 e t c h |
kṍrkĩ	 k õ ́ r k ĩ |
yuwèkã	 y u w è k ã |
iõ̀kã	 i õ ̀ k ã |
dóyal	 d ó y a l |
kèke	 k è k e |
kiöktsã	 k i ö k t s ã |
sulĩ̀	 s u l ĩ ̀ |
kièkètsã	 k i è k è t s ã |
mõnẽ̀tche	 m õ n ẽ ̀ t c h e |
kiök	 k i ö k |
wẽ́jkëtã	 w ẽ ́ j k ë t ã |
tö̀tchètsã	 t ö ̀ t c h è t s ã |
kũẽ̀ppa	 k ũ ẽ ̀ p p a |
ièã	 i è ã |
ièmĩ̀kã	 i è m ĩ ̀ k ã |
ièppakã	 i è p p a k ã |
́ĩ	 ́ ĩ |
tṹr	 t ũ ́ r |
bulámĩkö	 b u l á m ĩ k ö |
kũẽ̀wã	 k ũ ẽ ̀ w ã |
duwö́wã	 d u w ö ́ w ã |
õ̀n	 õ ̀ n |
të̀nẽ̀wã	 t ë ̀ n ẽ ̀ w ã |
bitèanẽ	 b i t è a n ẽ |
kàle	 k à l e |
tsẽ́mĩ	 t s ẽ ́ m ĩ |
rwó	 r w ó |
du'	 d u ' |
síwẽ̀mĩ	 s í w ẽ ̀ m ĩ |
tsã́kã	 t s ã ́ k ã |
síwẽ̀ppa	 s í w ẽ ̀ p p a |
e'ñẽ́rmã	 e ' ñ ẽ ́ r m ã |
sũwẽ́tche	 s ũ w ẽ ́ t c h e |
ewa	 e w a |
wö̀káwẽ	 w ö ̀ k á w ẽ |
kö̀kã	 k ö ̀ k ã |
sërërërërë	 s ë r ë r ë r ë r ë |
bua'ë!	 b u a ' ë ! |
kũẽ̀rà	 k ũ ẽ ̀ r à |
yú	 y ú |
sã́ũk	 s ã ́ ũ k |
mĩ́tsẽ	 m ĩ ́ t s ẽ |
biètsã	 b i è t s ã |
kũẽ̀	 k ũ ẽ ̀ |
síwẽ̀ke	 s í w ẽ ̀ k e |
dalèkua	 d a l è k u a |
tsébita	 t s é b i t a |
mũlũ̀lka	 m ũ l ũ ̀ l k a |
wö̀ñẽkètche	 w ö ̀ ñ ẽ k è t c h e |
mĩ́r	 m ĩ ́ r |
ë̀;	 ë ̀ ; |
yuwö̀keiã	 y u w ö ̀ k e i ã |
là	 l à |
wẽ́ri	 w ẽ ́ r i |
yànṍk	 y à n õ ́ k |
ñẽ́ẽrönẽ	 ñ ẽ ́ ẽ r ö n ẽ |
también	 t a m b i é n |
mẽ̀kètche;	 m ẽ ̀ k è t c h e ; |
ulàmẽ	 u l à m ẽ |
dàtsĩkenẽ	 d à t s ĩ k e n ẽ |
bitsök	 b i t s ö k |
wĩ̀ẽrö	 w ĩ ̀ ẽ r ö |
wẽ́̀	 w ẽ ́ ̀ |
ñĩ̀köl	 ñ ĩ ̀ k ö l |
ñĩ̀wẽ	 ñ ĩ ̀ w ẽ |
dapàrke	 d a p à r k e |
yö́kĩ	 y ö ́ k ĩ |
wö̀li	 w ö ̀ l i |
wõwṍ	 w õ w õ ́ |
lìrke	 l ì r k e |
katèkètche	 k a t è k è t c h e |
skíke	 s k í k e |
katé	 k a t é |
skíkanẽ	 s k í k a n ẽ |
katànẽ	 k a t à n ẽ |
áù	 á ù |
awé	 a w é |
sulùrkèwã	 s u l ù r k è w ã |
mẽ̀rkèwã	 m ẽ ̀ r k è w ã |
talvez	 t a l v e z |
shkákle	 s h k á k l e |
kàlkicha	 k à l k i c h a |
bayö̀blák	 b a y ö ̀ b l á k |
cherà	 c h e r à |
shkák	 s h k á k |
bakë̀nẽ	 b a k ë ̀ n ẽ |
sulùwẽ	 s u l ù w ẽ |
wẽ́jkëlè	 w ẽ ́ j k ë l è |
wẽ́jkële	 w ẽ ́ j k ë l e |
chebo	 c h e b o |
wéìr	 w é ì r |
sulùõwã	 s u l ù õ w ã |
làr	 l à r |
ñẽ́se	 ñ ẽ ́ s e |
sulùnẽ̀wã	 s u l ù n ẽ ̀ w ã |
chówã	 c h ó w ã |
verdad	 v e r d a d |
ahh	 a h h |
bikèitsèmĩ	 b i k è i t s è m ĩ |
ètk	 è t k |
shṹulat	 s h ũ ́ u l a t |
wìwö	 w ì w ö |
u̠jú̠	 u ̠ j ú ̠ |
tö́	 t ö ́ |
ká̠	 k á ̠ |
tèröl	 t è r ö l |
se'	 s e ' |
e's	 e ' s |
tër	 t ë r |
idirla	 i d i r l a |
e'	 e ' |
dör	 d ö r |
ie'	 i e ' |
dawè	 d a w è |
tè	 t è |
pú	 p ú |
irir	 i r i r |
kàl	 k à l |
wö	 w ö |
iene̠	 i e n e ̠ |
ie	 i e |
i	 i |
wà	 w à |
bë̂r	 b ë ̂ r |
yë̂ar	 y ë ̂ a r |
e'tk	 e ' t k |
ë̀	 ë ̀ |
ú̠jù̠	 ú ̠ j ù ̠ |
tsiö̀	 t s i ö ̀ |
ù	 ù |
batà	 b a t à |
uju	 u j u |
e'kët	 e ' k ë t |
ta̠	 t a ̠ |
bua'	 b u a ' |
wö̀na̠	 w ö ̀ n a ̠ |
dayë̀	 d a y ë ̀ |
yö̀ne̠	 y ö ̀ n e ̠ |
sibö̀	 s i b ö ̀ |
a̠	 a ̠ |
ché	 c h é |
be'	 b e ' |
e̠'	 e ̠ ' |
shkö́bitu̠	 s h k ö ́ b i t u ̠ |
a̠wí̠	 a ̠ w í ̠ |
kò̠s	 k ò ̠ s |
ki̠	 k i ̠ |
dawás	 d a w á s |
tso'	 t s o ' |
sìkuapa	 s ì k u a p a |
icha	 i c h a |
itö̀ièke̠	 i t ö ̀ i è k e ̠ |
no	 n o |
ì	 ì |
se'la	 s e ' l a |
yö́	 y ö ́ |
söla	 s ö l a |
sö	 s ö |
balo'rila	 b a l o ' r i l a |
buáala	 b u á a l a |
balo'ri	 b a l o ' r i |
sharila	 s h a r i l a |
a̠là̠chkala	 a ̠ l à ̠ c h k a l a |
ta̠la	 t a ̠ l a |
ye'	 y e ' |
dawèka̠la	 d a w è k a ̠ l a |
aláköla	 a l á k ö l a |
sû̠	 s û ̠ |
sula'	 s u l a ' |
ichàkökala	 i c h à k ö k a l a |
kirë̀rma̠	 k i r ë ̀ r m a ̠ |
kirë̀rma̠la	 k i r ë ̀ r m a ̠ l a |
wö̀	 w ö ̀ |
a̠la	 a ̠ l a |
kë̀la	 k ë ̀ l a |
aë̀rwala	 a ë ̀ r w a l a |
töla	 t ö l a |
ìla	 ì l a |
aë̀	 a ë ̀ |
ijtsèmi̠la	 i j t s è m i ̠ l a |
à	 à |
kë́këpa	 k ë ́ k ë p a |
i̠'ñe̠	 i ̠ ' ñ e ̠ |
sa'	 s a ' |
tö	 t ö |
mí̠a̠	 m í ̠ a ̠ |
wë'stela	 w ë ' s t e l a |
ta̠î̠ë	 t a ̠ î ̠ ë |
ujté	 u j t é |
ta̠î̠	 t a ̠ î ̠ |
kabéne̠	 k a b é n e ̠ |
we'ine̠	 w e ' i n e ̠ |
si̠à̠rë	 s i ̠ à ̠ r ë |
yàmi̠pa	 y à m i ̠ p a |
we'ike	 w e ' i k e |
wa̠	 w a ̠ |
bua'ë	 b u a ' ë |
kí̠mè̠ke̠	 k í ̠ m è ̠ k e ̠ |
ku̠é̠ki̠	 k u ̠ é ̠ k i ̠ |
é̠n	 é ̠ n |
chak	 c h a k |
kiè	 k i è |
alà	 a l à |
kie	 k i e |
jesús	 j e s ú s |
amén	 a m é n |
ké̠we	 k é ̠ w e |
tsiru'	 t s i r u ' |
tèke̠	 t è k e ̠ |
tsakèke̠	 t s a k è k e ̠ |
é	 é |
ma̠	 m a ̠ |
shkö́wè̠ke̠	 s h k ö ́ w è ̠ k e ̠ |
síkwa	 s í k w a |
të́rulewa̠	 t ë ́ r u l e w a ̠ |
ékëpa	 é k ë p a |
mè̠ke̠ttsa̠	 m è ̠ k e ̠ t t s a ̠ |
dìba	 d ì b a |
sìne̠	 s ì n e ̠ |
kukèke̠	 k u k è k e ̠ |
wö̀ppèke̠	 w ö ̀ p p è k e ̠ |
wèke̠	 w è k e ̠ |
tabèchka	 t a b è c h k a |
ki̠ka	 k i ̠ k a |
blôblô	 b l ô b l ô |
chkà	 c h k à |
páköl	 p á k ö l |
mi̠	 m i ̠ |
mè̠ke̠ka̠	 m è ̠ k e ̠ k a ̠ |
bö'	 b ö ' |
daléwa	 d a l é w a |
mo̠ló̠tsmo̠ló̠ts	 m o ̠ l ó ̠ t s m o ̠ l ó ̠ t s |
íyi	 í y i |
ièka̠	 i è k a ̠ |
i̠a̠	 i ̠ a ̠ |
sìkua	 s ì k u a |
canela	 c a n e l a |
e̠ma̠	 e ̠ m a ̠ |
dlásháwö	 d l á s h á w ö |
shá̠mé̠la	 s h á ̠ m é ̠ l a |
apà	 a p à |
butrèke̠wa̠	 b u t r è k e ̠ w a ̠ |
yë́jkuö	 y ë ́ j k u ö |
wa	 w a |
ta̠wè̠ke̠	 t a ̠ w è ̠ k e ̠ |
bulu'pa	 b u l u ' p a |
bueno	 b u e n o |
í̠e̠	 í ̠ e ̠ |
rè	 r è |
e'ta̠	 e ' t a ̠ |
yulár	 y u l á r |
wö̀ke̠	 w ö ̀ k e ̠ |
wè̠s	 w è ̠ s |
a'r	 a ' r |
sa̠wè̠	 s a ̠ w è ̠ |
bribripa	 b r i b r i p a |
ák	 á k |
mè̠a̠t	 m è ̠ a ̠ t |
wö́köl	 w ö ́ k ö l |
kë̀	 k ë ̀ |
ô̠ka	 ô ̠ k a |
mè̠ne̠a̠t	 m è ̠ n e ̠ a ̠ t |
wö́k	 w ö ́ k |
a̠wì̠	 a ̠ w ì ̠ |
pàke	 p à k e |
rë'ka̠	 r ë ' k a ̠ |
dià	 d i à |
kièke̠	 k i è k e ̠ |
ká̠ska	 k á ̠ s k a |
ma̠nè̠te̠	 m a ̠ n è ̠ t e ̠ |
ditsö̀wö	 d i t s ö ̀ w ö |
ikuö̀wö	 i k u ö ̀ w ö |
ése	 é s e |
ditséwö	 d i t s é w ö |
mì̠ka̠	 m ì ̠ k a ̠ |
tskìne̠	 t s k ì n e ̠ |
sulàyöm	 s u l à y ö m |
me̠'a̠t	 m e ̠ ' a ̠ t |
ñá̠no̠	 ñ á ̠ n o ̠ |
katáno̠	 k a t á n o ̠ |
chkö́köl	 c h k ö ́ k ö l |
sè̠nu̠köl	 s è ̠ n u ̠ k ö l |
î̠ñe̠	 î ̠ ñ e ̠ |
katèke̠	 k a t è k e ̠ |
mì̠k	 m ì ̠ k |
nê̠ne̠	 n ê ̠ n e ̠ |
hasta	 h a s t a |
rö	 r ö |
sì̠na̠	 s ì ̠ n a ̠ |
éjkë	 é j k ë |
i̠à̠na̠	 i ̠ à ̠ n a ̠ |
tso'se̠n	 t s o ' s e ̠ n |
ùrke̠	 ù r k e ̠ |
ujtö̀ie	 u j t ö ̀ i e |
sé̠rke̠	 s é ̠ r k e ̠ |
bùsila	 b ù s i l a |
wö́ulâù̠ke̠	 w ö ́ u l â ù ̠ k e ̠ |
ö	 ö |
bùsi	 b ù s i |
ulà	 u l à |
batsèmi̠	 b a t s è m i ̠ |
mà̠so	 m à ̠ s o |
kú̠rmi̠	 k ú ̠ r m i ̠ |
wö́ulâna̠tketke	 w ö ́ u l â n a ̠ t k e t k e |
éki	 é k i |
sé̠	 s é ̠ |
tsè̠ke̠	 t s è ̠ k e ̠ |
éyökie	 é y ö k i e |
dö̀ka̠	 d ö ̀ k a ̠ |
ékölëme̠	 é k ö l ë m e ̠ |
rö̀	 r ö ̀ |
ké̠	 k é ̠ |
blo'	 b l o ' |
yèke̠	 y è k e ̠ |
chkö̀ke̠rak	 c h k ö ̀ k e ̠ r a k |
tso'rak	 t s o ' r a k |
ñî̠	 ñ î ̠ |
ñì̠	 ñ ì ̠ |
kímu̠kdak	 k í m u ̠ k d a k |
wé̠se	 w é ̠ s e |
yìr	 y ì r |
ièke̠	 i è k e ̠ |
ñé̠	 ñ é ̠ |
wé̠shke̠	 w é ̠ s h k e ̠ |
mì̠kle	 m ì ̠ k l e |
a̠wí̠es	 a ̠ w í ̠ e s |
e'rör	 e ' r ö r |
wé̠	 w é ̠ |
e'köl	 e ' k ö l |
yì	 y ì |
bua'r	 b u a ' r |
kià̠na̠	 k i à ̠ n a ̠ |
e̠'rö	 e ̠ ' r ö |
wákpa	 w á k p a |
sé̠ndak	 s é ̠ n d a k |
ujtö̀	 u j t ö ̀ |
sé̠n	 s é ̠ n |
tsikìne̠	 t s i k ì n e ̠ |
amù̠bli	 a m ù ̠ b l i |
talàne̠	 t a l à n e ̠ |
mama	 m a m a |
bö̀k	 b ö ̀ k |
ma̠nè̠ta̠	 m a ̠ n è ̠ t a ̠ |
ñe̠'	 ñ e ̠ ' |
klö̀	 k l ö ̀ |
este	 e s t e |
boca	 b o c a |
urén	 u r é n |
ká̠batà	 k á ̠ b a t à |
ma̠nè̠t	 m a ̠ n è ̠ t |
kibí	 k i b í |
que	 q u e |
ya	 y a |
yö	 y ö |
esposo	 e s p o s o |
ta̠'	 t a ̠ ' |
dë'rö	 d ë ' r ö |
tsú̠k	 t s ú ̠ k |
entonces	 e n t o n c e s |
dìwö	 d ì w ö |
dé	 d é |
kúkur	 k ú k u r |
pàköl	 p à k ö l |
i'	 i ' |
pero	 p e r o |
dë'	 d ë ' |
dë'tsa̠	 d ë ' t s a ̠ |
sè̠ne̠	 s è ̠ n e ̠ |
yàk	 y à k |
sa̠	 s a ̠ |
casi	 c a s i |
e'k	 e ' k |
ukö̀ki̠	 u k ö ̀ k i ̠ |
yö'	 y ö ' |
ahora	 a h o r a |
sí	 s í |
tkë̀r	 t k ë ̀ r |
ká̠m	 k á ̠ m |
chö̀wa	 c h ö ̀ w a |
yë́	 y ë ́ |
si̠wa̠'	 s i ̠ w a ̠ ' |
të'r	 t ë ' r |
ala'rala	 a l a ' r a l a |
tskìna̠	 t s k ì n a ̠ |
kù̠na̠	 k ù ̠ n a ̠ |
ie'pa	 i e ' p a |
hospital	 h o s p i t a l |
talàna̠	 t a l à n a ̠ |
wö́ulâa̠'	 w ö ́ u l â a ̠ ' |
sa̠ú̠k	 s a ̠ ú ̠ k |
pôó̠rulur	 p ô ó ̠ r u l u r |
kibìna̠	 k i b ì n a ̠ |
mí̠tke	 m í ̠ t k e |
solo	 s o l o |
à̠te̠	 à ̠ t e ̠ |
e'köla	 e ' k ö l a |
porque	 p o r q u e |
dë'u̠ntu	 d ë ' u ̠ n t u |
e'tala	 e ' t a l a |
chóla	 c h ó l a |
chë'wa	 c h ë ' w a |
ajá	 a j á |
ujú	 u j ú |
como	 c o m o |
ajké̠	 a j k é ̠ |
propio	 p r o p i o |
ye'r	 y e ' r |
mí̠k	 m í ̠ k |
alí	 a l í |
cortadora	 c o r t a d o r a |
té	 t é |
kókó	 k ó k ó |
détsa̠	 d é t s a ̠ |
tal	 t a l |
vez	 v e z |
saco	 s a c o |
be'r	 b e ' r |
mé̠a̠t	 m é ̠ a ̠ t |
dö̀	 d ö ̀ |
su̠lì̠tu	 s u ̠ l ì ̠ t u |
mé̠r	 m é ̠ r |
síu̠k	 s í u ̠ k |
bétk	 b é t k |
sìna̠wa̠	 s ì n a ̠ w a ̠ |
sìna̠	 s ì n a ̠ |
tkë́l	 t k ë ́ l |
kukèke̠tke	 k u k è k e ̠ t k e |
ù̠	 ù ̠ |
bá	 b á |
sa̠ú̠	 s a ̠ ú ̠ |
kukö́k	 k u k ö ́ k |
katùna̠	 k a t ù n a ̠ |
wö̀ishchèke̠	 w ö ̀ i s h c h è k e ̠ |
ajkuö́lit	 a j k u ö ́ l i t |
yéulur	 y é u l u r |
máquina	 m á q u i n a |
sa'r	 s a ' r |
i̠â̠chkí	 i ̠ â ̠ c h k í |
kukö̀ke̠	 k u k ö ̀ k e ̠ |
a'	 a ' |
pàkeke̠	 p à k e k e ̠ |
tskírke̠	 t s k í r k e ̠ |
chè	 c h è |
mí̠ka̠	 m í ̠ k a ̠ |
e'rö	 e ' r ö |
ñá̠	 ñ á ̠ |
a̠mì̠	 a ̠ m ì ̠ |
kiàna̠	 k i à n a ̠ |
pàkuemle̠	 p à k u e m l e ̠ |
óköpa	 ó k ö p a |
rë́ka̠	 r ë ́ k a ̠ |
wíköl	 w í k ö l |
pàtkeke̠	 p à t k e k e ̠ |
mè̠bitu̠	 m è ̠ b i t u ̠ |
yawè	 y a w è |
di'	 d i ' |
rë́ka̠i̠a̠	 r ë ́ k a ̠ i ̠ a ̠ |
pà	 p à |
sùne̠	 s ù n e ̠ |
ka̠nè̠u̠k	 k a ̠ n è ̠ u ̠ k |
bitè̠	 b i t è ̠ |
pàtkebitu̠	 p à t k e b i t u ̠ |
chèa̠t	 c h è a ̠ t |
ké	 k é |
ka̠nè̠u̠	 k a ̠ n è ̠ u ̠ |
mí̠tkemu̠le̠	 m í ̠ t k e m u ̠ l e ̠ |
ujtè	 u j t è |
mí̠ke̠mu̠le̠	 m í ̠ k e ̠ m u ̠ l e ̠ |
satë̀	 s a t ë ̀ |
kìta̠	 k ì t a ̠ |
mé̠mu̠le̠	 m é ̠ m u ̠ l e ̠ |
sa̠wé̠	 s a ̠ w é ̠ |
mò̠ki̠	 m ò ̠ k i ̠ |
yë'	 y ë ' |
se'r	 s e ' r |
ka̠nè̠o̠'	 k a ̠ n è ̠ o ̠ ' |
kí̠	 k í ̠ |
bakò̠s	 b a k ò ̠ s |
a̠ñì̠es	 a ̠ ñ ì ̠ e s |
i̠ù̠te	 i ̠ ù ̠ t e |
chèrak	 c h è r a k |
idir	 i d i r |
katè	 k a t è |
ajkë́u̠k	 a j k ë ́ u ̠ k |
kàne̠	 k à n e ̠ |
a̠ñì̠	 a ̠ ñ ì ̠ |
yö̀ki̠	 y ö ̀ k i ̠ |
à̠s	 à ̠ s |
tsikìna̠	 t s i k ì n a ̠ |
réwa̠	 r é w a ̠ |
sè̠nu̠k	 s è ̠ n u ̠ k |
dalë́ri	 d a l ë ́ r i |
dalö̀iökdak	 d a l ö ̀ i ö k d a k |
yë'a̠t	 y ë ' a ̠ t |
tsikírke̠	 t s i k í r k e ̠ |
ñé̠e̠	 ñ é ̠ e ̠ |
tsá̠we	 t s á ̠ w e |
dë́bitu̠dak	 d ë ́ b i t u ̠ d a k |
bö́l	 b ö ́ l |
ma̠ñá̠l	 m a ̠ ñ á ̠ l |
ë̀me̠	 ë ̀ m e ̠ |
e'pa	 e ' p a |
wé	 w é |
wéla	 w é l a |
tkë́rka̠	 t k ë ́ r k a ̠ |
tkë́rka̠rak	 t k ë ́ r k a ̠ r a k |
alákölpa	 a l á k ö l p a |
bitu̠ke̠rak	 b i t u ̠ k e ̠ r a k |
ala'r	 a l a ' r |
tsikírke̠tke	 t s i k í r k e ̠ t k e |
awá	 a w á |
óköm	 ó k ö m |
kapèblök	 k a p è b l ö k |
bátsena̠mu̠le̠	 b á t s e n a ̠ m u ̠ l e ̠ |
ka̠nè̠wè̠ke̠	 k a ̠ n è ̠ w è ̠ k e ̠ |
wák	 w á k |
ka'	 k a ' |
bák	 b á k |
tsîr	 t s î r |
ká̠mî̠ë	 k á ̠ m î ̠ ë |
cabagra	 c a b a g r a |
ajkö̀	 a j k ö ̀ |
a̠wí̠she̠t	 a ̠ w í ̠ s h e ̠ t |
ë̀ka̠	 ë ̀ k a ̠ |
santa	 s a n t a |
elena	 e l e n a |
puente	 p u e n t e |
mí̠ke̠	 m í ̠ k e ̠ |
mú̠köl	 m ú ̠ k ö l |
talâo̠	 t a l â o ̠ |
mì̠	 m ì ̠ |
êköl	 ê k ö l |
wë̂i̠a̠	 w ë ̂ i ̠ a ̠ |
escuela	 e s c u e l a |
skà	 s k à |
ichàkeke̠	 i c h à k e k e ̠ |
wö́blar	 w ö ́ b l a r |
ni̠mà̠	 n i ̠ m à ̠ |
kalíu̠k	 k a l í u ̠ k |
mí̠kalè	 m í ̠ k a l è |
ka̠ñí̠k	 k a ̠ ñ í ̠ k |
bàn	 b à n |
ùyöm	 ù y ö m |
wé̠alè	 w é ̠ a l è |
dë́rule	 d ë ́ r u l e |
apàkö́	 a p à k ö ́ |
ña̠	 ñ a ̠ |
kalíwe̠	 k a l í w e ̠ |
ukö̀	 u k ö ̀ |
mí̠	 m í ̠ |
bö	 b ö |
wö̀iewa̠	 w ö ̀ i e w a ̠ |
á̠jà̠	 á ̠ j à ̠ |
pues	 p u e s |
té̠rke̠	 t é ̠ r k e ̠ |
ké̠kra	 k é ̠ k r a |
diö́	 d i ö ́ |
río	 r í o |
y	 y |
cordillera	 c o r d i l l e r a |
mi̠k	 m i ̠ k |
muchos	 m u c h o s |
digamos	 d i g a m o s |
i̠â̠i̠â̠	 i ̠ â ̠ i ̠ â ̠ |
jké̠	 j k é ̠ |
sàl	 s à l |
ö̀k	 ö ̀ k |
íyiwak	 í y i w a k |
êrë	 ê r ë |
chìchi	 c h ì c h i |
yë́s	 y ë ́ s |
ajkè̠n	 a j k è ̠ n |
ni̠mé̠i	 n i ̠ m é ̠ i |
mu̠lû̠wak	 m u ̠ l û ̠ w a k |
dakòlwak	 d a k ò l w a k |
wàtak	 w à t a k |
kàlni̠me̠	 k à l n i ̠ m e ̠ |
bulë̀rwak	 b u l ë ̀ r w a k |
ñí̠we	 ñ í ̠ w e |
na̠ñé̠we	 n a ̠ ñ é ̠ w e |
mì̠kalê	 m ì ̠ k a l ê |
ñê̠es	 ñ ê ̠ e s |
bìt	 b ì t |
ulàttöu̠k	 u l à t t ö u ̠ k |
aû	 a û |
bö̀tk	 b ö ̀ t k |
ma̠ñà̠tk	 m a ̠ ñ à ̠ t k |
tsé̠a̠t	 t s é ̠ a ̠ t |
kapë́rule	 k a p ë ́ r u l e |
kapö̀ke̠	 k a p ö ̀ k e ̠ |
sík	 s í k |
kö̀	 k ö ̀ |
yawèka̠	 y a w è k a ̠ |
dikì̠	 d i k ì ̠ |
chkö̀	 c h k ö ̀ |
mí̠rule	 m í ̠ r u l e |
àrros	 à r r o s |
así	 a s í |
kalö́m	 k a l ö ́ m |
mismo	 m i s m o |
sí̠	 s í ̠ |
dapö̀	 d a p ö ̀ |
ku̠é̠	 k u ̠ é ̠ |
bìl	 b ì l |
yàmi̠	 y à m i ̠ |
nada	 n a d a |
sú̠rule	 s ú ̠ r u l e |
chö̀ke̠wa	 c h ö ̀ k e ̠ w a |
ìs	 ì s |
shkè̠na̠	 s h k è ̠ n a ̠ |
í̠ma̠	 í ̠ m a ̠ |
natividad	 n a t i v i d a d |
alto	 a l t o |
dùriña̠k	 d ù r i ñ a ̠ k |
wé̠jkë	 w é ̠ j k ë |
à̠ta̠	 à ̠ t a ̠ |
élke	 é l k e |
ma̠ñà̠t	 m a ̠ ñ à ̠ t |
ulàt	 u l à t |
shkö́k	 s h k ö ́ k |
ká̠pakö	 k á ̠ p a k ö |
wös	 w ö s |
dë́ka̠	 d ë ́ k a ̠ |
pàkö	 p à k ö |
me̠'	 m e ̠ ' |
ajkà	 a j k à |
a̠mé̠a̠t	 a ̠ m é ̠ a ̠ t |
dë́bitu̠	 d ë ́ b i t u ̠ |
dù	 d ù |
di'la	 d i ' l a |
dùri	 d ù r i |
akuö́k	 a k u ö ́ k |
me̠'ka̠	 m e ̠ ' k a ̠ |
mí̠chôka̠	 m í ̠ c h ô k a ̠ |
déka̠	 d é k a ̠ |
na̠mà̠söl	 n a ̠ m à ̠ s ö l |
ká̠bata	 k á ̠ b a t a |
tkër	 t k ë r |
ie'r	 i e ' r |
na̠mà̠ie	 n a ̠ m à ̠ i e |
e'r	 e ' r |
átuwö	 á t u w ö |
a̠me̠'a̠t	 a ̠ m e ̠ ' a ̠ t |
dalö̀	 d a l ö ̀ |
tulúr	 t u l ú r |
dalóie	 d a l ó i e |
ë́ltë	 ë ́ l t ë |
ditsö̀	 d i t s ö ̀ |
ajkö́nu̠k	 a j k ö ́ n u ̠ k |
ajkö́no̠	 a j k ö ́ n o ̠ |
na̠mé̠söl	 n a ̠ m é ̠ s ö l |
bë̂rie	 b ë ̂ r i e |
tso'tke	 t s o ' t k e |
ta̠'tke	 t a ̠ ' t k e |
blë'këkëpa	 b l ë ' k ë k ë p a |
i̠â̠chki	 i ̠ â ̠ c h k i |
ujché̠r	 u j c h é ̠ r |
sibö̀r	 s i b ö ̀ r |
pàka'	 p à k a ' |
pàkane̠	 p à k a n e ̠ |
tsítsir	 t s í t s i r |
wö́su̠k	 w ö ́ s u ̠ k |
ka̠nè̠blë'	 k a ̠ n è ̠ b l ë ' |
cha̠mù̠	 c h a ̠ m ù ̠ |
kuátkö̀ke̠	 k u á t k ö ̀ k e ̠ |
yawö́k	 y a w ö ́ k |
sè̠no̠	 s è ̠ n o ̠ |
mi̠kalè	 m i ̠ k a l è |
ikuö̀	 i k u ö ̀ |
itö̀tèke̠	 i t ö ̀ t è k e ̠ |
wë̀na̠la	 w ë ̀ n a ̠ l a |
ka̠nè̠we̠ke̠	 k a ̠ n è ̠ w e ̠ k e ̠ |
bíl	 b í l |
shkà̠ta̠ne̠	 s h k à ̠ t a ̠ n e ̠ |
dö̀mi̠	 d ö ̀ m i ̠ |
dabòm	 d a b ò m |
bö́yök	 b ö ́ y ö k |
sé̠r	 s é ̠ r |
tsè	 t s è |
yàmi̠pala	 y à m i ̠ p a l a |
ka̠nè̠we̠	 k a ̠ n è ̠ w e ̠ |
inú̠köl	 i n ú ̠ k ö l |
u̠'ù̠	 u ̠ ' ù ̠ |
wàto̠no̠	 w à t o ̠ n o ̠ |
ë́	 ë ́ |
wakpa	 w a k p a |
ka̠nè̠blö̀ke̠	 k a ̠ n è ̠ b l ö ̀ k e ̠ |
sa̠wè̠ke̠	 s a ̠ w è ̠ k e ̠ |
ka̠nè̠blöke̠	 k a ̠ n è ̠ b l ö k e ̠ |
àrrosla	 à r r o s l a |
kuatkè	 k u a t k è |
katàno̠	 k a t à n o ̠ |
alátsitsi	 a l á t s i t s i |
êla	 ê l a |
wêikö	 w ê i k ö |
pàkano̠	 p à k a n o ̠ |
démi̠	 d é m i ̠ |
e't	 e ' t |
tulúa̠t	 t u l ú a ̠ t |
sulàyibi	 s u l à y i b i |
katàblë'	 k a t à b l ë ' |
diö̀ya'	 d i ö ̀ y a ' |
suléyibi	 s u l é y i b i |
wébalök	 w é b a l ö k |
kirë̀rma̠pa	 k i r ë ̀ r m a ̠ p a |
i̠	 i ̠ |
bâwe̠	 b â w e ̠ |
tsë'ka	 t s ë ' k a |
mâ̠ma̠	 m â ̠ m a ̠ |
oro	 o r o |
kâne̠	 k â n e ̠ |
tsiríu̠k	 t s i r í u ̠ k |
kö́k	 k ö ́ k |
dalö̀iök	 d a l ö ̀ i ö k |
ajkö́nu̠ne̠	 a j k ö ́ n u ̠ n e ̠ |
sulû	 s u l û |
wámblër	 w á m b l ë r |
chö̀ulur	 c h ö ̀ u l u r |
dawö̀ulur	 d a w ö ̀ u l u r |
ñî̠köl	 ñ î ̠ k ö l |
i̠à̠rtse̠	 i ̠ à ̠ r t s e ̠ |
e'töm	 e ' t ö m |
ttö̀	 t t ö ̀ |
ie'rö	 i e ' r ö |
kuátkë	 k u á t k ë |
ulìta̠ne̠	 u l ì t a ̠ n e ̠ |
mì̠ne̠	 m ì ̠ n e ̠ |
kuátkök	 k u á t k ö k |
wa'ñe̠	 w a ' ñ e ̠ |
aì	 a ì |
chô	 c h ô |
wö̀wo̠	 w ö ̀ w o ̠ |
tsikírmi̠	 t s i k í r m i ̠ |
è̠ne̠wa̠mi̠	 è ̠ n e ̠ w a ̠ m i ̠ |
mì̠kalè	 m ì ̠ k a l è |
dè	 d è |
tsiríwe̠ke̠	 t s i r í w e ̠ k e ̠ |
tsiríwe̠	 t s i r í w e ̠ |
ké̠bata	 k é ̠ b a t a |
me̠'ie	 m e ̠ ' i e |
kiéka̠	 k i é k a ̠ |
kìne̠ka̠	 k ì n e ̠ k a ̠ |
kièka̠	 k i è k a ̠ |
à̠na̠wa̠	 à ̠ n a ̠ w a ̠ |
tsétse	 t s é t s e |
wámblö	 w á m b l ö |
kiàne̠	 k i à n e ̠ |
kë́sik	 k ë ́ s i k |
balö̀mi̠ne̠	 b a l ö ̀ m i ̠ n e ̠ |
ujtèmi̠	 u j t è m i ̠ |
wö́kir	 w ö ́ k i r |
dalë́wè̠	 d a l ë ́ w è ̠ |
kirìwe̠wa̠	 k i r ì w e ̠ w a ̠ |
kiár	 k i á r |
ká̠wö	 k á ̠ w ö |
mé̠rmi̠	 m é ̠ r m i ̠ |
da'	 d a ' |
kú̠nu̠k	 k ú ̠ n u ̠ k |
ajkö́ne̠	 a j k ö ́ n e ̠ |
dö̀pa	 d ö ̀ p a |
ska	 s k a |
wake'	 w a k e ' |
à̠te̠tke	 à ̠ t e ̠ t k e |
itö̀	 i t ö ̀ |
es	 e s |
érë	 é r ë |
ka̠nè̠	 k a ̠ n è ̠ |
ka̠nè̠wè̠mi̠	 k a ̠ n è ̠ w è ̠ m i ̠ |
púchi	 p ú c h i |
tsikìnu̠k	 t s i k ì n u ̠ k |
sha̠lê̠lê̠	 s h a ̠ l ê ̠ l ê ̠ |
ë	 ë |
kicha	 k i c h a |
chö	 c h ö |
shà̠	 s h à ̠ |
báne̠t	 b á n e ̠ t |
cha̠mù̠la	 c h a ̠ m ù ̠ l a |
kuátkèmi̠	 k u á t k è m i ̠ |
kuátke	 k u á t k e |
wö̀batse	 w ö ̀ b a t s e |
ésela	 é s e l a |
tsikír	 t s i k í r |
mí̠tkene̠	 m í ̠ t k e n e ̠ |
mú̠	 m ú ̠ |
kuála	 k u á l a |
ka̠nè̠o̠rmi̠	 k a ̠ n è ̠ o ̠ r m i ̠ |
iku̠á̠ki̠	 i k u ̠ á ̠ k i ̠ |
sé̠râ	 s é ̠ r â |
a̠mù̠bli	 a ̠ m ù ̠ b l i |
coroma	 c o r o m a |
i̠à̠ne̠	 i ̠ à ̠ n e ̠ |
ma̠nè̠ne̠tsa̠	 m a ̠ n è ̠ n e ̠ t s a ̠ |
bribriwak	 b r i b r i w a k |
bikéitse̠	 b i k é i t s e ̠ |
a̠mè̠ne̠a̠t	 a ̠ m è ̠ n e ̠ a ̠ t |
a̠mè̠ne̠	 a ̠ m è ̠ n e ̠ |
ië̀ka̠	 i ë ̀ k a ̠ |
ku̠é̠i̠	 k u ̠ é ̠ i ̠ |
siempre	 s i e m p r e |
alè	 a l è |
rë	 r ë |
të̀	 t ë ̀ |
tu̠è̠	 t u ̠ è ̠ |
kuáble	 k u á b l e |
átu	 á t u |
ali'	 a l i ' |
apì	 a p ì |
sawák	 s a w á k |
wè̠	 w è ̠ |
ajkàyë'	 a j k à y ë ' |
ka̠nè̠ble	 k a ̠ n è ̠ b l e |
ala'rla	 a l a ' r l a |
tièra	 t i è r a |
êjkë	 ê j k ë |
ká̠ñi̠rke̠	 k á ̠ ñ i ̠ r k e ̠ |
ká̠tuírke̠	 k á ̠ t u í r k e ̠ |
kó̠	 k ó ̠ |
íjkë	 í j k ë |
ma̠lé̠pa	 m a ̠ l é ̠ p a |
wö̀blao̠'	 w ö ̀ b l a o ̠ ' |
ka̠nè̠blök	 k a ̠ n è ̠ b l ö k |
yulö́k	 y u l ö ́ k |
àk	 à k |
balèku̠	 b a l è k u ̠ |
balè	 b a l è |
sulûë	 s u l û ë |
ka̠nè̠bleke̠	 k a ̠ n è ̠ b l e k e ̠ |
ajkàche	 a j k à c h e |
yö̂mi̠	 y ö ̂ m i ̠ |
yö̀ne̠mi̠	 y ö ̀ n e ̠ m i ̠ |
varios	 v a r i o s |
wö́ulârke̠	 w ö ́ u l â r k e ̠ |
wö́ulâne̠	 w ö ́ u l â n e ̠ |
tsö́k	 t s ö ́ k |
erë	 e r ë |
wö̂ikèke̠	 w ö ̂ i k è k e ̠ |
wö́ulâo̠	 w ö ́ u l â o ̠ |
wö́ulâo̠mi̠	 w ö ́ u l â o ̠ m i ̠ |
é̠ma̠	 é ̠ m a ̠ |
raúl	 r a ú l |
méndez	 m é n d e z |
ujchè̠n	 u j c h è ̠ n |
à̠	 à ̠ |
bikéitsèke̠	 b i k é i t s è k e ̠ |
yàli	 y à l i |
apàke	 a p à k e |
alatsítsi	 a l a t s í t s i |
wö̂ikmi̠	 w ö ̂ i k m i ̠ |
alàtsítsi	 a l à t s í t s i |
wö̂ik	 w ö ̂ i k |
bitu̠	 b i t u ̠ |
wö̂ike	 w ö ̂ i k e |
wö̂ìna̠	 w ö ̂ ì n a ̠ |
tka'	 t k a ' |
tawàlia	 t a w à l i a |
ñé̠es	 ñ é ̠ e s |
kë́këpala	 k ë ́ k ë p a l a |
àlim	 à l i m |
pa	 p a |
kö̀chi	 k ö ̀ c h i |
krò	 k r ò |
bàka	 b à k a |
kabàiö	 k a b à i ö |
kalö̀	 k a l ö ̀ |
o̠'mi̠k	 o ̠ ' m i ̠ k |
kàlkö	 k à l k ö |
dóma̠le̠	 d ó m a ̠ l e ̠ |
ka̠nè̠wo̠	 k a ̠ n è ̠ w o ̠ |
ichö́kle	 i c h ö ́ k l e |
ró	 r ó |
shirë́kö	 s h i r ë ́ k ö |
klòkö	 k l ò k ö |
shu̠lé̠	 s h u ̠ l é ̠ |
sö̀kkö	 s ö ̀ k k ö |
dapáwe̠ma̠le̠	 d a p á w e ̠ m a ̠ l e ̠ |
páliu̠köl	 p á l i u ̠ k ö l |
aîkö	 a î k ö |
bitù̠ke̠ma̠le̠	 b i t ù ̠ k e ̠ m a ̠ l e ̠ |
tsè̠	 t s è ̠ |
bítkuak	 b í t k u a k |
bö́tkuak	 b ö ́ t k u a k |
tkë́yök	 t k ë ́ y ö k |
sìtla	 s ì t l a |
wö̂iko	 w ö ̂ i k o |
étkuak	 é t k u a k |
tkabë̀	 t k a b ë ̀ |
kuéwa̠	 k u é w a ̠ |
ie'par	 i e ' p a r |
tsî̠	 t s î ̠ |
âr	 â r |
apàkö	 a p à k ö |
bulù	 b u l ù |
tsítsipala	 t s í t s i p a l a |
talâr	 t a l â r |
pàtu	 p à t u |
pú̠	 p ú ̠ |
irö̀	 i r ö ̀ |
cómo	 c ó m o |
se	 s e |
llama	 l l a m a |
kayö́	 k a y ö ́ |
dùsi̠a̠	 d ù s i ̠ a ̠ |
pík	 p í k |
ku̠ka̠'	 k u ̠ k a ̠ ' |
wö́ni̠k	 w ö ́ n i ̠ k |
pulë̀	 p u l ë ̀ |
tsítsipa	 t s í t s i p a |
kalö'wo̠	 k a l ö ' w o ̠ |
shù̠	 s h ù ̠ |
mâ̠tkle	 m â ̠ t k l e |
apàto	 a p à t o |
na̠mù̠	 n a ̠ m ù ̠ |
akà	 a k à |
talók	 t a l ó k |
akàla	 a k à l a |
pà̠rlor	 p à ̠ r l o r |
wë́	 w ë ́ |
jueputa	 j u e p u t a |
si̠nà̠s	 s i ̠ n à ̠ s |
kö	 k ö |
vea	 v e a |
bakèla	 b a k è l a |
bakè	 b a k è |
bika'	 b i k a ' |
yë̀ñapala	 y ë ̀ ñ a p a l a |
pàtököl	 p à t ö k ö l |
wéblö	 w é b l ö |
tsè̠bitu̠	 t s è ̠ b i t u ̠ |
dalé	 d a l é |
ujtö́	 u j t ö ́ |
tsî̠ne̠t	 t s î ̠ n e ̠ t |
krá	 k r á |
wö́rki̠	 w ö ́ r k i ̠ |
kuë̀	 k u ë ̀ |
wì̠m	 w ì ̠ m |
wìm	 w ì m |
kachúk	 k a c h ú k |
alö̀buk	 a l ö ̀ b u k |
urrì	 u r r ì |
dakòlum	 d a k ò l u m |
stsí	 s t s í |
wàpie	 w à p i e |
ês	 ê s |
biké	 b i k é |
apàyo	 a p à y o |
wé̠s	 w é ̠ s |
batséi	 b a t s é i |
iki'wè̠ka̠	 i k i ' w è ̠ k a ̠ |
iska	 i s k a |
wé̠ma̠le̠	 w é ̠ m a ̠ l e ̠ |
tsé̠mi̠	 t s é ̠ m i ̠ |
tsule'	 t s u l e ' |
e'ta	 e ' t a |
shù̠aline̠	 s h ù ̠ a l i n e ̠ |
bikéitse	 b i k é i t s e |
batsé	 b a t s é |
bukulú	 b u k u l ú |
ña̠là̠	 ñ a ̠ l à ̠ |
tse̠ke̠	 t s e ̠ k e ̠ |
katúr	 k a t ú r |
klö́m	 k l ö ́ m |
klö́bli	 k l ö ́ b l i |
sé̠se̠	 s é ̠ s e ̠ |
sé̠se̠la	 s é ̠ s e ̠ l a |
yè	 y è |
kuáblök	 k u á b l ö k |
buë'	 b u ë ' |
kuá	 k u á |
wé̠alê	 w é ̠ a l ê |
el	 e l |
muchacho	 m u c h a c h o |
akë́chkeël	 a k ë ́ c h k e ë l |
êskapë	 ê s k a p ë |
tsîrlaël	 t s î r l a ë l |
stsa'wö	 s t s a ' w ö |
colegio	 c o l e g i o |
ka̠nè̠blö	 k a ̠ n è ̠ b l ö |
wö̀blane̠	 w ö ̀ b l a n e ̠ |
ñè̠	 ñ è ̠ |
ñè̠ke̠	 ñ è ̠ k e ̠ |
na̠i̠'chka	 n a ̠ i ̠ ' c h k a |
katàne̠	 k a t à n e ̠ |
à̠a̠	 à ̠ a ̠ |
na̠i̠'	 n a ̠ i ̠ ' |
ditsö̀wöpa	 d i t s ö ̀ w ö p a |
u̠jú̠	 u ̠ j ú ̠ |
tö́	 t ö ́ |
ká̠	 k á ̠ |
tèröl	 t è r ö l |
se'	 s e ' |
e's	 e ' s |
tër	 t ë r |
idirla	 i d i r l a |
e'	 e ' |
dör	 d ö r |
ie'	 i e ' |
dawè	 d a w è |
tè	 t è |
pú	 p ú |
irir	 i r i r |
kàl	 k à l |
wö	 w ö |
iene̠	 i e n e ̠ |
ie	 i e |
i	 i |
wà	 w à |
bë̂r	 b ë ̂ r |
yë̂ar	 y ë ̂ a r |
e'tk	 e ' t k |
ë̀	 ë ̀ |
ú̠jù̠	 ú ̠ j ù ̠ |
tsiö̀	 t s i ö ̀ |
ù	 ù |
batà	 b a t à |
uju	 u j u |
e'kët	 e ' k ë t |
ta̠	 t a ̠ |
bua'	 b u a ' |
wö̀na̠	 w ö ̀ n a ̠ |
dayë̀	 d a y ë ̀ |
yö̀ne̠	 y ö ̀ n e ̠ |
sibö̀	 s i b ö ̀ |
a̠	 a ̠ |
ché	 c h é |
be'	 b e ' |
e̠'	 e ̠ ' |
shkö́bitu̠	 s h k ö ́ b i t u ̠ |
a̠wí̠	 a ̠ w í ̠ |
kò̠s	 k ò ̠ s |
ki̠	 k i ̠ |
dawás	 d a w á s |
tso'	 t s o ' |
sìkuapa	 s ì k u a p a |
icha	 i c h a |
itö̀ièke̠	 i t ö ̀ i è k e ̠ |
no	 n o |
ì	 ì |
se'la	 s e ' l a |
yö́	 y ö ́ |
söla	 s ö l a |
sö	 s ö |
balo'rila	 b a l o ' r i l a |
buáala	 b u á a l a |
balo'ri	 b a l o ' r i |
sharila	 s h a r i l a |
a̠là̠chkala	 a ̠ l à ̠ c h k a l a |
ta̠la	 t a ̠ l a |
ye'	 y e ' |
dawèka̠la	 d a w è k a ̠ l a |
aláköla	 a l á k ö l a |
sû̠	 s û ̠ |
sula'	 s u l a ' |
ichàkökala	 i c h à k ö k a l a |
kirë̀rma̠	 k i r ë ̀ r m a ̠ |
kirë̀rma̠la	 k i r ë ̀ r m a ̠ l a |
wö̀	 w ö ̀ |
a̠la	 a ̠ l a |
kë̀la	 k ë ̀ l a |
aë̀rwala	 a ë ̀ r w a l a |
töla	 t ö l a |
ìla	 ì l a |
aë̀	 a ë ̀ |
ijtsèmi̠la	 i j t s è m i ̠ l a |
à	 à |
kë́këpa	 k ë ́ k ë p a |
i̠'ñe̠	 i ̠ ' ñ e ̠ |
sa'	 s a ' |
tö	 t ö |
mí̠a̠	 m í ̠ a ̠ |
wë'stela	 w ë ' s t e l a |
ta̠î̠ë	 t a ̠ î ̠ ë |
ujté	 u j t é |
ta̠î̠	 t a ̠ î ̠ |
kabéne̠	 k a b é n e ̠ |
we'ine̠	 w e ' i n e ̠ |
si̠à̠rë	 s i ̠ à ̠ r ë |
yàmi̠pa	 y à m i ̠ p a |
we'ike	 w e ' i k e |
wa̠	 w a ̠ |
bua'ë	 b u a ' ë |
kí̠mè̠ke̠	 k í ̠ m è ̠ k e ̠ |
ku̠é̠ki̠	 k u ̠ é ̠ k i ̠ |
é̠n	 é ̠ n |
chak	 c h a k |
kiè	 k i è |
alà	 a l à |
kie	 k i e |
jesús	 j e s ú s |
amén	 a m é n |
ké̠we	 k é ̠ w e |
tsiru'	 t s i r u ' |
tèke̠	 t è k e ̠ |
tsakèke̠	 t s a k è k e ̠ |
é	 é |
ma̠	 m a ̠ |
shkö́wè̠ke̠	 s h k ö ́ w è ̠ k e ̠ |
síkwa	 s í k w a |
të́rulewa̠	 t ë ́ r u l e w a ̠ |
ékëpa	 é k ë p a |
mè̠ke̠ttsa̠	 m è ̠ k e ̠ t t s a ̠ |
dìba	 d ì b a |
sìne̠	 s ì n e ̠ |
kukèke̠	 k u k è k e ̠ |
wö̀ppèke̠	 w ö ̀ p p è k e ̠ |
wèke̠	 w è k e ̠ |
tabèchka	 t a b è c h k a |
ki̠ka	 k i ̠ k a |
blôblô	 b l ô b l ô |
chkà	 c h k à |
páköl	 p á k ö l |
mi̠	 m i ̠ |
mè̠ke̠ka̠	 m è ̠ k e ̠ k a ̠ |
bö'	 b ö ' |
daléwa	 d a l é w a |
mo̠ló̠tsmo̠ló̠ts	 m o ̠ l ó ̠ t s m o ̠ l ó ̠ t s |
íyi	 í y i |
ièka̠	 i è k a ̠ |
i̠a̠	 i ̠ a ̠ |
sìkua	 s ì k u a |
canela	 c a n e l a |
e̠ma̠	 e ̠ m a ̠ |
dlásháwö	 d l á s h á w ö |
shá̠mé̠la	 s h á ̠ m é ̠ l a |
apà	 a p à |
butrèke̠wa̠	 b u t r è k e ̠ w a ̠ |
yë́jkuö	 y ë ́ j k u ö |
wa	 w a |
ta̠wè̠ke̠	 t a ̠ w è ̠ k e ̠ |
bulu'pa	 b u l u ' p a |
bueno	 b u e n o |
í̠e̠	 í ̠ e ̠ |
rè	 r è |
e'ta̠	 e ' t a ̠ |
yulár	 y u l á r |
wö̀ke̠	 w ö ̀ k e ̠ |
wè̠s	 w è ̠ s |
a'r	 a ' r |
sa̠wè̠	 s a ̠ w è ̠ |
bribripa	 b r i b r i p a |
ák	 á k |
mè̠a̠t	 m è ̠ a ̠ t |
wö́köl	 w ö ́ k ö l |
kë̀	 k ë ̀ |
ô̠ka	 ô ̠ k a |
mè̠ne̠a̠t	 m è ̠ n e ̠ a ̠ t |
wö́k	 w ö ́ k |
a̠wì̠	 a ̠ w ì ̠ |
pàke	 p à k e |
rë'ka̠	 r ë ' k a ̠ |
dià	 d i à |
kièke̠	 k i è k e ̠ |
ká̠ska	 k á ̠ s k a |
ma̠nè̠te̠	 m a ̠ n è ̠ t e ̠ |
ditsö̀wö	 d i t s ö ̀ w ö |
ikuö̀wö	 i k u ö ̀ w ö |
ése	 é s e |
ditséwö	 d i t s é w ö |
mì̠ka̠	 m ì ̠ k a ̠ |
tskìne̠	 t s k ì n e ̠ |
sulàyöm	 s u l à y ö m |
me̠'a̠t	 m e ̠ ' a ̠ t |
ñá̠no̠	 ñ á ̠ n o ̠ |
katáno̠	 k a t á n o ̠ |
chkö́köl	 c h k ö ́ k ö l |
sè̠nu̠köl	 s è ̠ n u ̠ k ö l |
î̠ñe̠	 î ̠ ñ e ̠ |
katèke̠	 k a t è k e ̠ |
mì̠k	 m ì ̠ k |
nê̠ne̠	 n ê ̠ n e ̠ |
hasta	 h a s t a |
rö	 r ö |
sì̠na̠	 s ì ̠ n a ̠ |
éjkë	 é j k ë |
i̠à̠na̠	 i ̠ à ̠ n a ̠ |
tso'se̠n	 t s o ' s e ̠ n |
ùrke̠	 ù r k e ̠ |
ujtö̀ie	 u j t ö ̀ i e |
sé̠rke̠	 s é ̠ r k e ̠ |
bùsila	 b ù s i l a |
wö́ulâù̠ke̠	 w ö ́ u l â ù ̠ k e ̠ |
ö	 ö |
bùsi	 b ù s i |
ulà	 u l à |
batsèmi̠	 b a t s è m i ̠ |
mà̠so	 m à ̠ s o |
kú̠rmi̠	 k ú ̠ r m i ̠ |
wö́ulâna̠tketke	 w ö ́ u l â n a ̠ t k e t k e |
éki	 é k i |
sé̠	 s é ̠ |
tsè̠ke̠	 t s è ̠ k e ̠ |
éyökie	 é y ö k i e |
dö̀ka̠	 d ö ̀ k a ̠ |
ékölëme̠	 é k ö l ë m e ̠ |
rö̀	 r ö ̀ |
ké̠	 k é ̠ |
blo'	 b l o ' |
yèke̠	 y è k e ̠ |
chkö̀ke̠rak	 c h k ö ̀ k e ̠ r a k |
tso'rak	 t s o ' r a k |
ñî̠	 ñ î ̠ |
ñì̠	 ñ ì ̠ |
kímu̠kdak	 k í m u ̠ k d a k |
wé̠se	 w é ̠ s e |
yìr	 y ì r |
ièke̠	 i è k e ̠ |
ñé̠	 ñ é ̠ |
wé̠shke̠	 w é ̠ s h k e ̠ |
mì̠kle	 m ì ̠ k l e |
a̠wí̠es	 a ̠ w í ̠ e s |
e'rör	 e ' r ö r |
wé̠	 w é ̠ |
e'köl	 e ' k ö l |
yì	 y ì |
bua'r	 b u a ' r |
kià̠na̠	 k i à ̠ n a ̠ |
e̠'rö	 e ̠ ' r ö |
wákpa	 w á k p a |
sé̠ndak	 s é ̠ n d a k |
ujtö̀	 u j t ö ̀ |
sé̠n	 s é ̠ n |
tsikìne̠	 t s i k ì n e ̠ |
amù̠bli	 a m ù ̠ b l i |
talàne̠	 t a l à n e ̠ |
mama	 m a m a |
bö̀k	 b ö ̀ k |
ma̠nè̠ta̠	 m a ̠ n è ̠ t a ̠ |
ñe̠'	 ñ e ̠ ' |
klö̀	 k l ö ̀ |
este	 e s t e |
boca	 b o c a |
urén	 u r é n |
ká̠batà	 k á ̠ b a t à |
ma̠nè̠t	 m a ̠ n è ̠ t |
kibí	 k i b í |
que	 q u e |
ya	 y a |
yö	 y ö |
esposo	 e s p o s o |
ta̠'	 t a ̠ ' |
dë'rö	 d ë ' r ö |
tsú̠k	 t s ú ̠ k |
entonces	 e n t o n c e s |
dìwö	 d ì w ö |
dé	 d é |
kúkur	 k ú k u r |
pàköl	 p à k ö l |
i'	 i ' |
pero	 p e r o |
dë'	 d ë ' |
dë'tsa̠	 d ë ' t s a ̠ |
sè̠ne̠	 s è ̠ n e ̠ |
yàk	 y à k |
sa̠	 s a ̠ |
casi	 c a s i |
e'k	 e ' k |
ukö̀ki̠	 u k ö ̀ k i ̠ |
yö'	 y ö ' |
ahora	 a h o r a |
sí	 s í |
tkë̀r	 t k ë ̀ r |
ká̠m	 k á ̠ m |
chö̀wa	 c h ö ̀ w a |
yë́	 y ë ́ |
si̠wa̠'	 s i ̠ w a ̠ ' |
të'r	 t ë ' r |
ala'rala	 a l a ' r a l a |
tskìna̠	 t s k ì n a ̠ |
kù̠na̠	 k ù ̠ n a ̠ |
ie'pa	 i e ' p a |
hospital	 h o s p i t a l |
talàna̠	 t a l à n a ̠ |
wö́ulâa̠'	 w ö ́ u l â a ̠ ' |
sa̠ú̠k	 s a ̠ ú ̠ k |
pôó̠rulur	 p ô ó ̠ r u l u r |
kibìna̠	 k i b ì n a ̠ |
mí̠tke	 m í ̠ t k e |
solo	 s o l o |
à̠te̠	 à ̠ t e ̠ |
e'köla	 e ' k ö l a |
porque	 p o r q u e |
dë'u̠ntu	 d ë ' u ̠ n t u |
e'tala	 e ' t a l a |
chóla	 c h ó l a |
chë'wa	 c h ë ' w a |
ajá	 a j á |
ujú	 u j ú |
como	 c o m o |
ajké̠	 a j k é ̠ |
propio	 p r o p i o |
ye'r	 y e ' r |
mí̠k	 m í ̠ k |
alí	 a l í |
cortadora	 c o r t a d o r a |
té	 t é |
kókó	 k ó k ó |
détsa̠	 d é t s a ̠ |
tal	 t a l |
vez	 v e z |
saco	 s a c o |
be'r	 b e ' r |
mé̠a̠t	 m é ̠ a ̠ t |
dö̀	 d ö ̀ |
su̠lì̠tu	 s u ̠ l ì ̠ t u |
mé̠r	 m é ̠ r |
síu̠k	 s í u ̠ k |
bétk	 b é t k |
sìna̠wa̠	 s ì n a ̠ w a ̠ |
sìna̠	 s ì n a ̠ |
tkë́l	 t k ë ́ l |
kukèke̠tke	 k u k è k e ̠ t k e |
ù̠	 ù ̠ |
bá	 b á |
sa̠ú̠	 s a ̠ ú ̠ |
kukö́k	 k u k ö ́ k |
katùna̠	 k a t ù n a ̠ |
wö̀ishchèke̠	 w ö ̀ i s h c h è k e ̠ |
ajkuö́lit	 a j k u ö ́ l i t |
yéulur	 y é u l u r |
máquina	 m á q u i n a |
sa'r	 s a ' r |
i̠â̠chkí	 i ̠ â ̠ c h k í |
kukö̀ke̠	 k u k ö ̀ k e ̠ |
a'	 a ' |
pàkeke̠	 p à k e k e ̠ |
tskírke̠	 t s k í r k e ̠ |
chè	 c h è |
mí̠ka̠	 m í ̠ k a ̠ |
e'rö	 e ' r ö |
ñá̠	 ñ á ̠ |
a̠mì̠	 a ̠ m ì ̠ |
kiàna̠	 k i à n a ̠ |
pàkuemle̠	 p à k u e m l e ̠ |
óköpa	 ó k ö p a |
rë́ka̠	 r ë ́ k a ̠ |
wíköl	 w í k ö l |
pàtkeke̠	 p à t k e k e ̠ |
mè̠bitu̠	 m è ̠ b i t u ̠ |
yawè	 y a w è |
di'	 d i ' |
rë́ka̠i̠a̠	 r ë ́ k a ̠ i ̠ a ̠ |
pà	 p à |
sùne̠	 s ù n e ̠ |
ka̠nè̠u̠k	 k a ̠ n è ̠ u ̠ k |
bitè̠	 b i t è ̠ |
pàtkebitu̠	 p à t k e b i t u ̠ |
chèa̠t	 c h è a ̠ t |
ké	 k é |
ka̠nè̠u̠	 k a ̠ n è ̠ u ̠ |
mí̠tkemu̠le̠	 m í ̠ t k e m u ̠ l e ̠ |
ujtè	 u j t è |
mí̠ke̠mu̠le̠	 m í ̠ k e ̠ m u ̠ l e ̠ |
satë̀	 s a t ë ̀ |
kìta̠	 k ì t a ̠ |
mé̠mu̠le̠	 m é ̠ m u ̠ l e ̠ |
sa̠wé̠	 s a ̠ w é ̠ |
mò̠ki̠	 m ò ̠ k i ̠ |
yë'	 y ë ' |
se'r	 s e ' r |
ka̠nè̠o̠'	 k a ̠ n è ̠ o ̠ ' |
kí̠	 k í ̠ |
bakò̠s	 b a k ò ̠ s |
a̠ñì̠es	 a ̠ ñ ì ̠ e s |
i̠ù̠te	 i ̠ ù ̠ t e |
chèrak	 c h è r a k |
idir	 i d i r |
katè	 k a t è |
ajkë́u̠k	 a j k ë ́ u ̠ k |
kàne̠	 k à n e ̠ |
a̠ñì̠	 a ̠ ñ ì ̠ |
yö̀ki̠	 y ö ̀ k i ̠ |
à̠s	 à ̠ s |
tsikìna̠	 t s i k ì n a ̠ |
réwa̠	 r é w a ̠ |
sè̠nu̠k	 s è ̠ n u ̠ k |
dalë́ri	 d a l ë ́ r i |
dalö̀iökdak	 d a l ö ̀ i ö k d a k |
yë'a̠t	 y ë ' a ̠ t |
tsikírke̠	 t s i k í r k e ̠ |
ñé̠e̠	 ñ é ̠ e ̠ |
tsá̠we	 t s á ̠ w e |
dë́bitu̠dak	 d ë ́ b i t u ̠ d a k |
bö́l	 b ö ́ l |
ma̠ñá̠l	 m a ̠ ñ á ̠ l |
ë̀me̠	 ë ̀ m e ̠ |
e'pa	 e ' p a |
wé	 w é |
wéla	 w é l a |
tkë́rka̠	 t k ë ́ r k a ̠ |
tkë́rka̠rak	 t k ë ́ r k a ̠ r a k |
alákölpa	 a l á k ö l p a |
bitu̠ke̠rak	 b i t u ̠ k e ̠ r a k |
ala'r	 a l a ' r |
tsikírke̠tke	 t s i k í r k e ̠ t k e |
awá	 a w á |
óköm	 ó k ö m |
kapèblök	 k a p è b l ö k |
bátsena̠mu̠le̠	 b á t s e n a ̠ m u ̠ l e ̠ |
ka̠nè̠wè̠ke̠	 k a ̠ n è ̠ w è ̠ k e ̠ |
wák	 w á k |
ka'	 k a ' |
bák	 b á k |
tsîr	 t s î r |
ká̠mî̠ë	 k á ̠ m î ̠ ë |
cabagra	 c a b a g r a |
ajkö̀	 a j k ö ̀ |
a̠wí̠she̠t	 a ̠ w í ̠ s h e ̠ t |
ë̀ka̠	 ë ̀ k a ̠ |
santa	 s a n t a |
elena	 e l e n a |
puente	 p u e n t e |
mí̠ke̠	 m í ̠ k e ̠ |
mú̠köl	 m ú ̠ k ö l |
talâo̠	 t a l â o ̠ |
mì̠	 m ì ̠ |
êköl	 ê k ö l |
wë̂i̠a̠	 w ë ̂ i ̠ a ̠ |
escuela	 e s c u e l a |
skà	 s k à |
ichàkeke̠	 i c h à k e k e ̠ |
wö́blar	 w ö ́ b l a r |
ni̠mà̠	 n i ̠ m à ̠ |
kalíu̠k	 k a l í u ̠ k |
mí̠kalè	 m í ̠ k a l è |
ka̠ñí̠k	 k a ̠ ñ í ̠ k |
bàn	 b à n |
ùyöm	 ù y ö m |
wé̠alè	 w é ̠ a l è |
dë́rule	 d ë ́ r u l e |
apàkö́	 a p à k ö ́ |
ña̠	 ñ a ̠ |
kalíwe̠	 k a l í w e ̠ |
ukö̀	 u k ö ̀ |
mí̠	 m í ̠ |
bö	 b ö |
wö̀iewa̠	 w ö ̀ i e w a ̠ |
á̠jà̠	 á ̠ j à ̠ |
pues	 p u e s |
té̠rke̠	 t é ̠ r k e ̠ |
ké̠kra	 k é ̠ k r a |
diö́	 d i ö ́ |
río	 r í o |
y	 y |
cordillera	 c o r d i l l e r a |
mi̠k	 m i ̠ k |
muchos	 m u c h o s |
digamos	 d i g a m o s |
i̠â̠i̠â̠	 i ̠ â ̠ i ̠ â ̠ |
jké̠	 j k é ̠ |
sàl	 s à l |
ö̀k	 ö ̀ k |
íyiwak	 í y i w a k |
êrë	 ê r ë |
chìchi	 c h ì c h i |
yë́s	 y ë ́ s |
ajkè̠n	 a j k è ̠ n |
ni̠mé̠i	 n i ̠ m é ̠ i |
mu̠lû̠wak	 m u ̠ l û ̠ w a k |
dakòlwak	 d a k ò l w a k |
wàtak	 w à t a k |
kàlni̠me̠	 k à l n i ̠ m e ̠ |
bulë̀rwak	 b u l ë ̀ r w a k |
ñí̠we	 ñ í ̠ w e |
na̠ñé̠we	 n a ̠ ñ é ̠ w e |
mì̠kalê	 m ì ̠ k a l ê |
ñê̠es	 ñ ê ̠ e s |
bìt	 b ì t |
ulàttöu̠k	 u l à t t ö u ̠ k |
aû	 a û |
bö̀tk	 b ö ̀ t k |
ma̠ñà̠tk	 m a ̠ ñ à ̠ t k |
tsé̠a̠t	 t s é ̠ a ̠ t |
kapë́rule	 k a p ë ́ r u l e |
kapö̀ke̠	 k a p ö ̀ k e ̠ |
sík	 s í k |
kö̀	 k ö ̀ |
yawèka̠	 y a w è k a ̠ |
dikì̠	 d i k ì ̠ |
chkö̀	 c h k ö ̀ |
mí̠rule	 m í ̠ r u l e |
àrros	 à r r o s |
así	 a s í |
kalö́m	 k a l ö ́ m |
mismo	 m i s m o |
sí̠	 s í ̠ |
dapö̀	 d a p ö ̀ |
ku̠é̠	 k u ̠ é ̠ |
bìl	 b ì l |
yàmi̠	 y à m i ̠ |
nada	 n a d a |
sú̠rule	 s ú ̠ r u l e |
chö̀ke̠wa	 c h ö ̀ k e ̠ w a |
ìs	 ì s |
shkè̠na̠	 s h k è ̠ n a ̠ |
í̠ma̠	 í ̠ m a ̠ |
natividad	 n a t i v i d a d |
alto	 a l t o |
dùriña̠k	 d ù r i ñ a ̠ k |
wé̠jkë	 w é ̠ j k ë |
à̠ta̠	 à ̠ t a ̠ |
élke	 é l k e |
ma̠ñà̠t	 m a ̠ ñ à ̠ t |
ulàt	 u l à t |
shkö́k	 s h k ö ́ k |
ká̠pakö	 k á ̠ p a k ö |
wös	 w ö s |
dë́ka̠	 d ë ́ k a ̠ |
pàkö	 p à k ö |
me̠'	 m e ̠ ' |
ajkà	 a j k à |
a̠mé̠a̠t	 a ̠ m é ̠ a ̠ t |
dë́bitu̠	 d ë ́ b i t u ̠ |
dù	 d ù |
di'la	 d i ' l a |
dùri	 d ù r i |
akuö́k	 a k u ö ́ k |
me̠'ka̠	 m e ̠ ' k a ̠ |
mí̠chôka̠	 m í ̠ c h ô k a ̠ |
déka̠	 d é k a ̠ |
na̠mà̠söl	 n a ̠ m à ̠ s ö l |
ká̠bata	 k á ̠ b a t a |
tkër	 t k ë r |
ie'r	 i e ' r |
na̠mà̠ie	 n a ̠ m à ̠ i e |
e'r	 e ' r |
átuwö	 á t u w ö |
a̠me̠'a̠t	 a ̠ m e ̠ ' a ̠ t |
dalö̀	 d a l ö ̀ |
tulúr	 t u l ú r |
dalóie	 d a l ó i e |
ë́ltë	 ë ́ l t ë |
ditsö̀	 d i t s ö ̀ |
ajkö́nu̠k	 a j k ö ́ n u ̠ k |
ajkö́no̠	 a j k ö ́ n o ̠ |
na̠mé̠söl	 n a ̠ m é ̠ s ö l |
bë̂rie	 b ë ̂ r i e |
tso'tke	 t s o ' t k e |
ta̠'tke	 t a ̠ ' t k e |
blë'këkëpa	 b l ë ' k ë k ë p a |
i̠â̠chki	 i ̠ â ̠ c h k i |
ujché̠r	 u j c h é ̠ r |
sibö̀r	 s i b ö ̀ r |
pàka'	 p à k a ' |
pàkane̠	 p à k a n e ̠ |
tsítsir	 t s í t s i r |
wö́su̠k	 w ö ́ s u ̠ k |
ka̠nè̠blë'	 k a ̠ n è ̠ b l ë ' |
cha̠mù̠	 c h a ̠ m ù ̠ |
kuátkö̀ke̠	 k u á t k ö ̀ k e ̠ |
yawö́k	 y a w ö ́ k |
sè̠no̠	 s è ̠ n o ̠ |
mi̠kalè	 m i ̠ k a l è |
ikuö̀	 i k u ö ̀ |
itö̀tèke̠	 i t ö ̀ t è k e ̠ |
wë̀na̠la	 w ë ̀ n a ̠ l a |
ka̠nè̠we̠ke̠	 k a ̠ n è ̠ w e ̠ k e ̠ |
bíl	 b í l |
shkà̠ta̠ne̠	 s h k à ̠ t a ̠ n e ̠ |
dö̀mi̠	 d ö ̀ m i ̠ |
dabòm	 d a b ò m |
bö́yök	 b ö ́ y ö k |
sé̠r	 s é ̠ r |
tsè	 t s è |
yàmi̠pala	 y à m i ̠ p a l a |
ka̠nè̠we̠	 k a ̠ n è ̠ w e ̠ |
inú̠köl	 i n ú ̠ k ö l |
u̠'ù̠	 u ̠ ' ù ̠ |
wàto̠no̠	 w à t o ̠ n o ̠ |
ë́	 ë ́ |
wakpa	 w a k p a |
ka̠nè̠blö̀ke̠	 k a ̠ n è ̠ b l ö ̀ k e ̠ |
sa̠wè̠ke̠	 s a ̠ w è ̠ k e ̠ |
ka̠nè̠blöke̠	 k a ̠ n è ̠ b l ö k e ̠ |
àrrosla	 à r r o s l a |
kuatkè	 k u a t k è |
katàno̠	 k a t à n o ̠ |
alátsitsi	 a l á t s i t s i |
êla	 ê l a |
wêikö	 w ê i k ö |
pàkano̠	 p à k a n o ̠ |
démi̠	 d é m i ̠ |
e't	 e ' t |
tulúa̠t	 t u l ú a ̠ t |
sulàyibi	 s u l à y i b i |
katàblë'	 k a t à b l ë ' |
diö̀ya'	 d i ö ̀ y a ' |
suléyibi	 s u l é y i b i |
wébalök	 w é b a l ö k |
kirë̀rma̠pa	 k i r ë ̀ r m a ̠ p a |
i̠	 i ̠ |
bâwe̠	 b â w e ̠ |
tsë'ka	 t s ë ' k a |
mâ̠ma̠	 m â ̠ m a ̠ |
oro	 o r o |
kâne̠	 k â n e ̠ |
tsiríu̠k	 t s i r í u ̠ k |
kö́k	 k ö ́ k |
dalö̀iök	 d a l ö ̀ i ö k |
ajkö́nu̠ne̠	 a j k ö ́ n u ̠ n e ̠ |
sulû	 s u l û |
wámblër	 w á m b l ë r |
chö̀ulur	 c h ö ̀ u l u r |
dawö̀ulur	 d a w ö ̀ u l u r |
ñî̠köl	 ñ î ̠ k ö l |
i̠à̠rtse̠	 i ̠ à ̠ r t s e ̠ |
e'töm	 e ' t ö m |
ttö̀	 t t ö ̀ |
ie'rö	 i e ' r ö |
kuátkë	 k u á t k ë |
ulìta̠ne̠	 u l ì t a ̠ n e ̠ |
mì̠ne̠	 m ì ̠ n e ̠ |
kuátkök	 k u á t k ö k |
wa'ñe̠	 w a ' ñ e ̠ |
aì	 a ì |
chô	 c h ô |
wö̀wo̠	 w ö ̀ w o ̠ |
tsikírmi̠	 t s i k í r m i ̠ |
è̠ne̠wa̠mi̠	 è ̠ n e ̠ w a ̠ m i ̠ |
mì̠kalè	 m ì ̠ k a l è |
dè	 d è |
tsiríwe̠ke̠	 t s i r í w e ̠ k e ̠ |
tsiríwe̠	 t s i r í w e ̠ |
ké̠bata	 k é ̠ b a t a |
me̠'ie	 m e ̠ ' i e |
kiéka̠	 k i é k a ̠ |
kìne̠ka̠	 k ì n e ̠ k a ̠ |
kièka̠	 k i è k a ̠ |
à̠na̠wa̠	 à ̠ n a ̠ w a ̠ |
tsétse	 t s é t s e |
wámblö	 w á m b l ö |
kiàne̠	 k i à n e ̠ |
kë́sik	 k ë ́ s i k |
balö̀mi̠ne̠	 b a l ö ̀ m i ̠ n e ̠ |
ujtèmi̠	 u j t è m i ̠ |
wö́kir	 w ö ́ k i r |
dalë́wè̠	 d a l ë ́ w è ̠ |
kirìwe̠wa̠	 k i r ì w e ̠ w a ̠ |
kiár	 k i á r |
ká̠wö	 k á ̠ w ö |
mé̠rmi̠	 m é ̠ r m i ̠ |
da'	 d a ' |
kú̠nu̠k	 k ú ̠ n u ̠ k |
ajkö́ne̠	 a j k ö ́ n e ̠ |
dö̀pa	 d ö ̀ p a |
ska	 s k a |
wake'	 w a k e ' |
à̠te̠tke	 à ̠ t e ̠ t k e |
itö̀	 i t ö ̀ |
es	 e s |
érë	 é r ë |
ka̠nè̠	 k a ̠ n è ̠ |
ka̠nè̠wè̠mi̠	 k a ̠ n è ̠ w è ̠ m i ̠ |
púchi	 p ú c h i |
tsikìnu̠k	 t s i k ì n u ̠ k |
sha̠lê̠lê̠	 s h a ̠ l ê ̠ l ê ̠ |
ë	 ë |
kicha	 k i c h a |
chö	 c h ö |
shà̠	 s h à ̠ |
báne̠t	 b á n e ̠ t |
cha̠mù̠la	 c h a ̠ m ù ̠ l a |
kuátkèmi̠	 k u á t k è m i ̠ |
kuátke	 k u á t k e |
wö̀batse	 w ö ̀ b a t s e |
ésela	 é s e l a |
tsikír	 t s i k í r |
mí̠tkene̠	 m í ̠ t k e n e ̠ |
mú̠	 m ú ̠ |
kuála	 k u á l a |
ka̠nè̠o̠rmi̠	 k a ̠ n è ̠ o ̠ r m i ̠ |
iku̠á̠ki̠	 i k u ̠ á ̠ k i ̠ |
sé̠râ	 s é ̠ r â |
a̠mù̠bli	 a ̠ m ù ̠ b l i |
coroma	 c o r o m a |
i̠à̠ne̠	 i ̠ à ̠ n e ̠ |
ma̠nè̠ne̠tsa̠	 m a ̠ n è ̠ n e ̠ t s a ̠ |
bribriwak	 b r i b r i w a k |
bikéitse̠	 b i k é i t s e ̠ |
a̠mè̠ne̠a̠t	 a ̠ m è ̠ n e ̠ a ̠ t |
a̠mè̠ne̠	 a ̠ m è ̠ n e ̠ |
ië̀ka̠	 i ë ̀ k a ̠ |
ku̠é̠i̠	 k u ̠ é ̠ i ̠ |
siempre	 s i e m p r e |
alè	 a l è |
rë	 r ë |
të̀	 t ë ̀ |
tu̠è̠	 t u ̠ è ̠ |
kuáble	 k u á b l e |
átu	 á t u |
ali'	 a l i ' |
apì	 a p ì |
sawák	 s a w á k |
wè̠	 w è ̠ |
ajkàyë'	 a j k à y ë ' |
ka̠nè̠ble	 k a ̠ n è ̠ b l e |
ala'rla	 a l a ' r l a |
tièra	 t i è r a |
êjkë	 ê j k ë |
ká̠ñi̠rke̠	 k á ̠ ñ i ̠ r k e ̠ |
ká̠tuírke̠	 k á ̠ t u í r k e ̠ |
kó̠	 k ó ̠ |
íjkë	 í j k ë |
ma̠lé̠pa	 m a ̠ l é ̠ p a |
wö̀blao̠'	 w ö ̀ b l a o ̠ ' |
ka̠nè̠blök	 k a ̠ n è ̠ b l ö k |
yulö́k	 y u l ö ́ k |
àk	 à k |
balèku̠	 b a l è k u ̠ |
balè	 b a l è |
sulûë	 s u l û ë |
ka̠nè̠bleke̠	 k a ̠ n è ̠ b l e k e ̠ |
ajkàche	 a j k à c h e |
yö̂mi̠	 y ö ̂ m i ̠ |
yö̀ne̠mi̠	 y ö ̀ n e ̠ m i ̠ |
varios	 v a r i o s |
wö́ulârke̠	 w ö ́ u l â r k e ̠ |
wö́ulâne̠	 w ö ́ u l â n e ̠ |
tsö́k	 t s ö ́ k |
erë	 e r ë |
wö̂ikèke̠	 w ö ̂ i k è k e ̠ |
wö́ulâo̠	 w ö ́ u l â o ̠ |
wö́ulâo̠mi̠	 w ö ́ u l â o ̠ m i ̠ |
é̠ma̠	 é ̠ m a ̠ |
raúl	 r a ú l |
méndez	 m é n d e z |
ujchè̠n	 u j c h è ̠ n |
à̠	 à ̠ |
bikéitsèke̠	 b i k é i t s è k e ̠ |
yàli	 y à l i |
apàke	 a p à k e |
alatsítsi	 a l a t s í t s i |
wö̂ikmi̠	 w ö ̂ i k m i ̠ |
alàtsítsi	 a l à t s í t s i |
wö̂ik	 w ö ̂ i k |
bitu̠	 b i t u ̠ |
wö̂ike	 w ö ̂ i k e |
wö̂ìna̠	 w ö ̂ ì n a ̠ |
tka'	 t k a ' |
tawàlia	 t a w à l i a |
ñé̠es	 ñ é ̠ e s |
kë́këpala	 k ë ́ k ë p a l a |
àlim	 à l i m |
pa	 p a |
kö̀chi	 k ö ̀ c h i |
krò	 k r ò |
bàka	 b à k a |
kabàiö	 k a b à i ö |
kalö̀	 k a l ö ̀ |
o̠'mi̠k	 o ̠ ' m i ̠ k |
kàlkö	 k à l k ö |
dóma̠le̠	 d ó m a ̠ l e ̠ |
ka̠nè̠wo̠	 k a ̠ n è ̠ w o ̠ |
ichö́kle	 i c h ö ́ k l e |
ró	 r ó |
shirë́kö	 s h i r ë ́ k ö |
klòkö	 k l ò k ö |
shu̠lé̠	 s h u ̠ l é ̠ |
sö̀kkö	 s ö ̀ k k ö |
dapáwe̠ma̠le̠	 d a p á w e ̠ m a ̠ l e ̠ |
páliu̠köl	 p á l i u ̠ k ö l |
aîkö	 a î k ö |
bitù̠ke̠ma̠le̠	 b i t ù ̠ k e ̠ m a ̠ l e ̠ |
tsè̠	 t s è ̠ |
bítkuak	 b í t k u a k |
bö́tkuak	 b ö ́ t k u a k |
tkë́yök	 t k ë ́ y ö k |
sìtla	 s ì t l a |
wö̂iko	 w ö ̂ i k o |
étkuak	 é t k u a k |
tkabë̀	 t k a b ë ̀ |
kuéwa̠	 k u é w a ̠ |
ie'par	 i e ' p a r |
tsî̠	 t s î ̠ |
âr	 â r |
apàkö	 a p à k ö |
bulù	 b u l ù |
tsítsipala	 t s í t s i p a l a |
talâr	 t a l â r |
pàtu	 p à t u |
pú̠	 p ú ̠ |
irö̀	 i r ö ̀ |
cómo	 c ó m o |
se	 s e |
llama	 l l a m a |
kayö́	 k a y ö ́ |
dùsi̠a̠	 d ù s i ̠ a ̠ |
pík	 p í k |
ku̠ka̠'	 k u ̠ k a ̠ ' |
wö́ni̠k	 w ö ́ n i ̠ k |
pulë̀	 p u l ë ̀ |
tsítsipa	 t s í t s i p a |
kalö'wo̠	 k a l ö ' w o ̠ |
shù̠	 s h ù ̠ |
mâ̠tkle	 m â ̠ t k l e |
apàto	 a p à t o |
na̠mù̠	 n a ̠ m ù ̠ |
akà	 a k à |
talók	 t a l ó k |
akàla	 a k à l a |
pà̠rlor	 p à ̠ r l o r |
wë́	 w ë ́ |
jueputa	 j u e p u t a |
si̠nà̠s	 s i ̠ n à ̠ s |
kö	 k ö |
vea	 v e a |
bakèla	 b a k è l a |
bakè	 b a k è |
bika'	 b i k a ' |
yë̀ñapala	 y ë ̀ ñ a p a l a |
pàtököl	 p à t ö k ö l |
wéblö	 w é b l ö |
tsè̠bitu̠	 t s è ̠ b i t u ̠ |
dalé	 d a l é |
ujtö́	 u j t ö ́ |
tsî̠ne̠t	 t s î ̠ n e ̠ t |
krá	 k r á |
wö́rki̠	 w ö ́ r k i ̠ |
kuë̀	 k u ë ̀ |
wì̠m	 w ì ̠ m |
wìm	 w ì m |
kachúk	 k a c h ú k |
alö̀buk	 a l ö ̀ b u k |
urrì	 u r r ì |
dakòlum	 d a k ò l u m |
stsí	 s t s í |
wàpie	 w à p i e |
ês	 ê s |
biké	 b i k é |
apàyo	 a p à y o |
wé̠s	 w é ̠ s |
batséi	 b a t s é i |
iki'wè̠ka̠	 i k i ' w è ̠ k a ̠ |
iska	 i s k a |
wé̠ma̠le̠	 w é ̠ m a ̠ l e ̠ |
tsé̠mi̠	 t s é ̠ m i ̠ |
tsule'	 t s u l e ' |
e'ta	 e ' t a |
shù̠aline̠	 s h ù ̠ a l i n e ̠ |
bikéitse	 b i k é i t s e |
batsé	 b a t s é |
bukulú	 b u k u l ú |
ña̠là̠	 ñ a ̠ l à ̠ |
tse̠ke̠	 t s e ̠ k e ̠ |
katúr	 k a t ú r |
klö́m	 k l ö ́ m |
klö́bli	 k l ö ́ b l i |
sé̠se̠	 s é ̠ s e ̠ |
sé̠se̠la	 s é ̠ s e ̠ l a |
yè	 y è |
kuáblök	 k u á b l ö k |
buë'	 b u ë ' |
kuá	 k u á |
wé̠alê	 w é ̠ a l ê |
el	 e l |
muchacho	 m u c h a c h o |
akë́chkeël	 a k ë ́ c h k e ë l |
êskapë	 ê s k a p ë |
tsîrlaël	 t s î r l a ë l |
stsa'wö	 s t s a ' w ö |
colegio	 c o l e g i o |
ka̠nè̠blö	 k a ̠ n è ̠ b l ö |
wö̀blane̠	 w ö ̀ b l a n e ̠ |
ñè̠	 ñ è ̠ |
ñè̠ke̠	 ñ è ̠ k e ̠ |
na̠i̠'chka	 n a ̠ i ̠ ' c h k a |
katàne̠	 k a t à n e ̠ |
à̠a̠	 à ̠ a ̠ |
na̠i̠'	 n a ̠ i ̠ ' |
ditsö̀wöpa	 d i t s ö ̀ w ö p a |
shtàwẽ̀mĩ	 s h t à w ẽ ̀ m ĩ |
sĩõ'tãmĩ	 s ĩ õ ' t ã m ĩ |
	  |
wẽ̀s	 w ẽ ̀ s |
yö̀rmĩ	 y ö ̀ r m ĩ |
kãnẽ̀ũk	 k ã n ẽ ̀ ũ k |
yö̀rke	 y ö ̀ r k e |
mĩ̀kã	 m ĩ ̀ k ã |
yö̀rkèmĩ	 y ö ̀ r k è m ĩ |
batséitsèke	 b a t s é i t s è k e |
kãnẽ̀wẽ̀ke	 k ã n ẽ ̀ w ẽ ̀ k e |
kõ̀s	 k õ ̀ s |
ẽ'	 ẽ ' |
yawö̀ke	 y a w ö ̀ k e |
cha	 c h a |
kṍwötã	 k õ ́ w ö t ã |
íñẽ	 í ñ ẽ |
ã	 ã |
yuwè	 y u w è |
ĩ́ẽ	 ĩ ́ ẽ |
tchë̀r	 t c h ë ̀ r |
mṹ	 m ũ ́ |
yuwök	 y u w ö k |
chèmĩ	 c h è m ĩ |
wẽ́	 w ẽ ́ |
wĩ́se	 w ĩ ́ s e |
yuwákle	 y u w á k l e |
kĩ	 k ĩ |
kiànẽ	 k i à n ẽ |
yö̀r	 y ö ̀ r |
íñe	 í ñ e |
chàkök	 c h à k ö k |
dàtsĩtche	 d à t s ĩ t c h e |
mĩ̀tche	 m ĩ ̀ t c h e |
éẽrö	 é ẽ r ö |
éẽ	 é ẽ |
klö̀wẽ̀ke	 k l ö ̀ w ẽ ̀ k e |
tsuru'	 t s u r u ' |
kuö̀k	 k u ö ̀ k |
bikàkla	 b i k à k l a |
dur	 d u r |
ès	 è s |
bikékla	 b i k é k l a |
dùrkĩ	 d ù r k ĩ |
kabë̀la	 k a b ë ̀ l a |
ñẽ́ẽ	 ñ ẽ ́ ẽ |
diö̀	 d i ö ̀ |
yèkètche	 y è k è t c h e |
shkö̀	 s h k ö ̀ |
tchër	 t c h ë r |
klö̀rke	 k l ö ̀ r k e |
mẽ̀ke	 m ẽ ̀ k e |
kkué	 k k u é |
tsṍwek	 t s õ ́ w e k |
tsṍ	 t s õ ́ |
ẽ̀rpa	 ẽ ̀ r p a |
abuelita	 a b u e l i t a |
aìse	 a ì s e |
dàtsẽ	 d à t s ẽ |
klö̀ũk	 k l ö ̀ ũ k |
klö̀wẽke	 k l ö ̀ w ẽ k e |
m	 m |
mã	 m ã |
wĩ̀ke	 w ĩ ̀ k e |
dkrò	 d k r ò |
kö̀yök	 k ö ̀ y ö k |
kë́kë	 k ë ́ k ë |
kö̀yànẽ	 k ö ̀ y à n ẽ |
iã	 i ã |
ulítãnẽ	 u l í t ã n ẽ |
sẽ́rãã	 s ẽ ́ r ã ã |
ah	 a h |
kuö̀wöla	 k u ö ̀ w ö l a |
wö̀k	 w ö ̀ k |
wẽ	 w ẽ |
́	 ́ |
mĩ̀ke	 m ĩ ̀ k e |
sĩõ'	 s ĩ õ ' |
e'la	 e ' l a |
tã	 t ã |
yuwö̀kbala	 y u w ö ̀ k b a l a |
s	 s |
klö̀wẽ	 k l ö ̀ w ẽ |
kuö̀	 k u ö ̀ |
mĩ̀r	 m ĩ ̀ r |
r	 r |
kĩ́ka	 k ĩ ́ k a |
klö̀nẽ	 k l ö ̀ n ẽ |
dékã	 d é k ã |
tchétökicha	 t c h é t ö k i c h a |
e'tã	 e ' t ã |
lònẽ	 l ò n ẽ |
"	 " |
dö̀kã	 d ö ̀ k ã |
ñẽ'	 ñ ẽ ' |
mĩr	 m ĩ r |
wẽ̀ke	 w ẽ ̀ k e |
klö̀nẽ̀tche	 k l ö ̀ n ẽ ̀ t c h e |
kkuè	 k k u è |
õ̀ne	 õ ̀ n e |
bàwẽ̀ke	 b à w ẽ ̀ k e |
ulé	 u l é |
ulàklö̀ũ̀ke	 u l à k l ö ̀ ũ ̀ k e |
kúshki	 k ú s h k i |
ñãtchèke	 ñ ã t c h è k e |
ímã	 í m ã |
yuwèke	 y u w è k e |
bala	 b a l a |
i'tã	 i ' t ã |
tté	 t t é |
chök	 c h ö k |
""be'	 " " b e ' |
jkuö́""	 j k u ö ́ " " |
o	 o |
rpáũ""	 r p á ũ " " |
yulö́""	 y u l ö ́ " " |
surùrù	 s u r ù r ù |
yulèke	 y u l è k e |
ãã	 ã ã |
lèke	 l è k e |
chũmũ̀	 c h ũ m ũ ̀ |
wö̀tchèke	 w ö ̀ t c h è k e |
kö̀yèke	 k ö ̀ y è k e |
ttèke	 t t è k e |
kõ̀r	 k õ ̀ r |
sẽ́	 s ẽ ́ |
""íñẽ	 " " í ñ ẽ |
tsṍlĩ	 t s õ ́ l ĩ |
ñe'	 ñ e ' |
rpánẽ	 r p á n ẽ |
kõ̀re	 k õ ̀ r e |
rpánẽtche	 r p á n ẽ t c h e |
dà	 d à |
tulèkèwã	 t u l è k è w ã |
kerèè	 k e r è è |
kàltákla	 k à l t á k l a |
tãmĩ́	 t ã m ĩ ́ |
tchèkèwã	 t c h è k è w ã |
tãmĩ́pa	 t ã m ĩ ́ p a |
bátsike	 b á t s i k e |
timĩ́	 t i m ĩ ́ |
kë́chikè	 k ë ́ c h i k è |
mĩk	 m ĩ k |
kabë̀lala	 k a b ë ̀ l a l a |
kĩ́kã	 k ĩ ́ k ã |
ñẽ́jkë	 ñ ẽ ́ j k ë |
chakàla	 c h a k a ̀ l a |
élkela	 é l k e l a |
lìnẽ	 l ì n ẽ |
dikótö	 d i k ó t ö |
chö́k	 c h ö ́ k |
kö̀ppèkèkãtche	 k ö ̀ p p è k è k ã t c h e |
ñẽ́ẽrö	 ñ ẽ ́ ẽ r ö |
ñẽ̀kũ̀wã	 ñ ẽ ̀ k ũ ̀ w ã |
mẽ̀nẽ	 m ẽ ̀ n ẽ |
ñẽ̀wã	 ñ ẽ ̀ w ã |
ñẽ̀ke	 ñ ẽ ̀ k e |
ñẽ̀kewã	 ñ ẽ ̀ k e w ã |
wö̀mãnẽ̀rke	 w ö ̀ m ã n ẽ ̀ r k e |
wĩ́kĩ	 w ĩ ́ k ĩ |
ĩõ̀kĩ	 ĩ õ ̀ k ĩ |
èka	 è k a |
mẽ̀kènẽ	 m ẽ ̀ k è n ẽ |
tsṍkuèke	 t s õ ́ k u è k e |
tás	 t á s |
éwa	 é w a |
ñèke	 ñ è k e |
wĩ̀	 w ĩ ̀ |
tso'tche	 t s o ' t c h e |
tamĩ́	 t a m ĩ ́ |
kãnẽ́	 k ã n ẽ ́ |
mũlépa	 m ũ l é p a |
ñã̀nẽ	 ñ ã ̀ n ẽ |
ès	 e ̀ s |
kõ̀rë	 k õ ̀ r ë |
sũwẽ̀ke	 s ũ w ẽ ̀ k e |
yö̀rkela	 y ö ̀ r k e l a |
sũwẽ̀	 s ũ w ẽ ̀ |
rñẽ̀ẽ̀	 r ñ ẽ ̀ ẽ ̀ |
bulé	 b u l é |
wö̀të̀nẽ	 w ö ̀ t ë ̀ n ẽ |
ãñĩ̀es	 ã ñ ĩ ̀ e s |
bitsö̀ke	 b i t s ö ̀ k e |
ñĩ̀ĩ̀	 ñ ĩ ̀ ĩ ̀ |
bulàmĩ	 b u l à m ĩ |
shkènẽ	 s h k è n ẽ |
bità	 b i t à |
ñẽ̀kènẽ	 ñ ẽ ̀ k è n ẽ |
yèke	 y è k e |
pònẽ̀mĩ	 p ò n ẽ ̀ m ĩ |
mĩ̀chò	 m ĩ ̀ c h ò |
kãñĩ́k	 k ã ñ ĩ ́ k |
mĩ̀tsẽ	 m ĩ ̀ t s ẽ |
che	 c h e |
""tchẽ́k	 " " t c h ẽ ́ k |
rö̀nẽ	 r ö ̀ n ẽ |
íẽ	 í ẽ |
ã""	 ã " " |
wĩ́ẽ	 w ĩ ́ ẽ |
chòò	 c h ò ò |
ár	 á r |
tök	 t ö k |
ṹ	 ũ ́ |
ppṍ	 p p õ ́ |
rpö̀	 r p ö ̀ |
tchök	 t c h ö k |
tchö̀k	 t c h ö ̀ k |
rpáwẽ̀ke	 r p á w ẽ ̀ k e |
kapö̀ke	 k a p ö ̀ k e |
kapë̀ule	 k a p ë ̀ u l e |
shõ̀õ̀	 s h õ ̀ õ ̀ |
dö̀nẽ	 d ö ̀ n ẽ |
tchẽ́k	 t c h ẽ ́ k |
dàtsĩkènẽ	 d à t s ĩ k è n ẽ |
yö̀kĩkã	 y ö ̀ k ĩ k ã |
ãwĩ̀ẽ	 ã w ĩ ̀ ẽ |
wẽ́shkẽ	 w ẽ ́ s h k ẽ |
rpáũk	 r p á ũ k |
chãmũ̀	 c h ã m ũ ̀ |
jkuök	 j k u ö k |
dàtsikènẽ	 d à t s i k è n ẽ |
jkuö̀k	 j k u ö ̀ k |
yóie	 y ó i e |
chö́kale	 c h ö ́ k a l e |
ése;	 é s e ; |
jkuö̀k;	 j k u ö ̀ k ; |
yök	 y ö k |
bánẽt	 b á n ẽ t |
yàmĩpa	 y à m ĩ p a |
balèke	 b a l è k e |
èmã	 è m ã |
mĩ̀nã	 m ĩ ̀ n ã |
kutápa	 k u t á p a |
wĩ̀kela	 w ĩ ̀ k e l a |
yèse	 y è s e |
tso'se	 t s o ' s e |
mĩ̀	 m ĩ ̀ |
mĩ̀nẽ	 m ĩ ̀ n ẽ |
nẽ'	 n ẽ ' |
kujkuö̀k	 k u j k u ö ̀ k |
dénẽ	 d é n ẽ |
tsuru'la	 t s u r u ' l a |
jkué	 j k u é |
sũ̀	 s ũ ̀ |
wã	 w ã |
bitẽ́	 b i t ẽ ́ |
wĩ̀ẽ	 w ĩ ̀ ẽ |
tsṍkö̀rkètchenẽ	 t s õ ́ k ö ̀ r k è t c h e n ẽ |
éẽ;	 é ẽ ; |
pàsiwẽ̀ke	 p à s i w ẽ ̀ k e |
síule	 s í u l e |
kṍkö̀ie	 k õ ́ k ö ̀ i e |
árie	 á r i e |
dàtsike	 d à t s i k e |
èwa	 è w a |
tsṍkuèkènẽ	 t s õ ́ k u è k è n ẽ |
íke	 í k e |
ñẽ̀ẽ	 ñ ẽ ̀ ẽ |
débitũ	 d é b i t ũ |
su	 s u |
mĩ̀tchènẽ	 m ĩ ̀ t c h è n ẽ |
tsṍwẽ	 t s õ ́ w ẽ |
mĩ́	 m ĩ ́ |
tkótö	 t k ó t ö |
blo'la	 b l o ' l a |
blòblòla	 b l ò b l ò l a |
yèkènẽ	 y è k è n ẽ |
pë'	 p ë ' |
yànẽ	 y à n ẽ |
iál	 i á l |
sulùũke	 s u l ù ũ k e |
ẽ́n	 ẽ ́ n |
sũwẽ́	 s ũ w ẽ ́ |
õ̀nẽ	 õ ̀ n ẽ |
sulùõ̀wã	 s u l ù õ ̀ w ã |
èkapë	 e ̀ k a p ë |
mẽ́wẽ̀wã	 m ẽ ́ w ẽ ̀ w ã |
èkëpë	 è k ë p ë |
èkapë	 è k a p ë |
mẽ́nẽwã;	 m ẽ ́ n ẽ w ã ; |
kũẽ́kĩ	 k ũ ẽ ́ k ĩ |
chaké	 c h a k é |
mẽ̀nẽ̀ãt	 m ẽ ̀ n ẽ ̀ ã t |
yö̀ie	 y ö ̀ i e |
bàtan	 b à t a n |
yulèkètche	 y u l è k è t c h e |
yulök	 y u l ö k |
iö́k	 i ö ́ k |
dë̀	 d ë ̀ |
natalia	 n a t a l i a |
kièke	 k i è k e |
ñũ	 ñ ũ |
wĩ'	 w ĩ ' |
émã	 é m ã |
kë́chike	 k ë ́ c h i k e |
mĩ̀ke;	 m ĩ ̀ k e ; |
juwé	 j u w é |
mj	 m j |
tchë́l	 t c h ë ́ l |
sã́ũ	 s ã ́ ũ |
mĩ̀tchela	 m ĩ ̀ t c h e l a |
kué	 k u é |
katèke	 k a t è k e |
kùnẽ	 k ù n ẽ |
mĩ̀k	 m ĩ ̀ k |
juwá	 j u w á |
ẽh	 ẽ h |
juwápa	 j u w á p a |
yàrke	 y à r k e |
noo!	 n o o ! |
èklala	 è k l a l a |
yànũk	 y à n ũ k |
tã;	 t ã ; |
kũẽ́k	 k ũ ẽ ́ k |
yö̀rketche	 y ö ̀ r k e t c h e |
yuwö̀k	 y u w ö ̀ k |
yö̀nẽ	 y ö ̀ n ẽ |
èkalala	 è k a l a l a |
yé	 y é |
kuli'	 k u l i ' |
ië̀nẽ̀wã	 i ë ̀ n ẽ ̀ w ã |
iènẽ̀wã	 i è n ẽ ̀ w ã |
'õnõ̀s	 ' õ n õ ̀ s |
ièke	 i è k e |
ièkèwã	 i è k è w ã |
bitũ̀ke	 b i t ũ ̀ k e |
kũẽ́	 k ũ ẽ ́ |
iõ̀iõ̀	 i õ ̀ i õ ̀ |
dùla	 d ù l a |
tso'iã	 t s o ' i ã |
sũlĩ̀	 s ũ l ĩ ̀ |
kàsir	 k à s i r |
kõnõ'	 k õ n õ ' |
kũẽ̀iã	 k ũ ẽ ̀ i ã |
tö;	 t ö ; |
sh	 s h |
choò	 c h o ò |
chìchila	 c h ì c h i l a |
wö̀balawẽ́	 w ö ̀ b a l a w ẽ ́ |
yë́balök	 y ë ́ b a l ö k |
iálpa	 i á l p a |
yö̀kĩ	 y ö ̀ k ĩ |
anstasia	 a n s t a s i a |
démĩ	 d é m ĩ |
tö̀tchèkètche	 t ö ̀ t c h è k è t c h e |
tö̀tchök	 t ö ̀ t c h ö k |
tö̀tchök;	 t ö ̀ t c h ö k ; |
tö̀tchèke	 t ö ̀ t c h è k e |
kũẽ̀mĩ	 k ũ ẽ ̀ m ĩ |
kanẽ̀wẽ̀ke	 k a n ẽ ̀ w ẽ ̀ k e |
ñõ̀wẽ̀ke	 ñ õ ̀ w ẽ ̀ k e |
wẽ̀ke;	 w ẽ ̀ k e ; |
wö̀balaũ̀tche	 w ö ̀ b a l a ũ ̀ t c h e |
yë́syë̀së	 y ë ́ s y ë ̀ s ë |
mũ̀kètsã	 m ũ ̀ k è t s ã |
wö̀balaũ̀ke	 w ö ̀ b a l a ũ ̀ k e |
bitsö̀kkã	 b i t s ö ̀ k k ã |
alàla	 a l à l a |
kãnẽ̀wẽ̀ke;	 k ã n ẽ ̀ w ẽ ̀ k e ; |
mĩ̀ka	 m ĩ ̀ k a |
diö̀yàrke	 d i ö ̀ y à r k e |
ñĩ̀	 ñ ĩ ̀ |
diö̀yö̀ke	 d i ö ̀ y ö ̀ k e |
ñĩ̀we	 ñ ĩ ̀ w e |
tsṍwe	 t s õ ́ w e |
pàkètcha	 p à k è t c h a |
ñã̀nẽ;	 ñ ã ̀ n ẽ ; |
kṍmĩ	 k õ ́ m ĩ |
yö̀wã	 y ö ̀ w ã |
ñũ̀wã	 ñ ũ ̀ w ã |
õ̀rtã	 õ ̀ r t ã |
chö́k;	 c h ö ́ k ; |
dolò	 d o l ò |
ë̀mẽ	 ë ̀ m ẽ |
póppòë	 p ó p p ò ë |
yènẽ	 y è n ẽ |
kũ	 k ũ |
tsṍyànẽ	 t s õ ́ y à n ẽ |
ni	 n i |
chö́pa	 c h ö ́ p a |
kë́chikéla	 k ë ́ c h i k é l a |
kë́chiképàtche	 k ë ́ c h i k é p à t c h e |
yàrkètche	 y à r k è t c h e |
mĩ́la	 m ĩ ́ l a |
kák	 k á k |
yë̀nẽ	 y ë ̀ n ẽ |
wákpala	 w á k p a l a |
mẽ̀wẽ̀kewã;	 m ẽ ̀ w ẽ ̀ k e w ã ; |
chétcha	 c h é t c h a |
sulù	 s u l ù |
mẽ̀wẽ	 m ẽ ̀ w ẽ |
mẽ̀wẽ̀wã	 m ẽ ̀ w ẽ ̀ w ã |
ñĩ̀es	 ñ ĩ ̀ e s |
emã	 e m ã |
kapö̀k	 k a p ö ̀ k |
chò	 c h ò |
ñẽ'tã	 ñ ẽ ' t ã |
kũẽkĩ	 k ũ ẽ k ĩ |
ùla	 ù l a |
yuwö̀ke	 y u w ö ̀ k e |
tchër;	 t c h ë r ; |
wèla	 w è l a |
ètökicha	 è t ö k i c h a |
shkök	 s h k ö k |
kẽ́ũk	 k ẽ ́ ũ k |
kuö̀kĩ	 k u ö ̀ k ĩ |
tã́iã	 t ã ́ i ã |
bitsèbita	 b i t s è b i t a |
mĩ̀nẽã	 m ĩ ̀ n ẽ ã |
m'm	 m ' m |
èttsinĩ	 è t t s i n ĩ |
ñẽ́es	 ñ ẽ ́ e s |
kölö̀wẽ	 k ö l ö ̀ w ẽ |
í	 í |
dapárke	 d a p á r k e |
ulàwa	 u l à w a |
wĩ̀es;	 w ĩ ̀ e s ; |
ulàwa;	 u l à w a ; |
mm	 m m |
mẽlẽ̀ã	 m ẽ l ẽ ̀ ã |
pàkök	 p à k ö k |
rpárke	 r p á r k e |
bítökicha	 b í t ö k i c h a |
tsṍyèke	 t s õ ́ y è k e |
bö̀tökicha	 b ö ̀ t ö k i c h a |
tchë́tokicha	 t c h ë ́ t o k i c h a |
kãnẽ̀wèke	 k ã n ẽ ̀ w è k e |
kẽ́wek	 k ẽ ́ w e k |
mẽnẽ̀wẽ̀ke	 m ẽ n ẽ ̀ w ẽ ̀ k e |
un	 u n |
poco	 p o c o |
kãnẽ̀wẽ	 k ã n ẽ ̀ w ẽ |
mĩchòë	 m ĩ c h ò ë |
kẽ́krà	 k ẽ ́ k r à |
dàtsikène	 d à t s i k è n e |
ri	 r i |
mĩ̀nẽ̀nẽ	 m ĩ ̀ n ẽ ̀ n ẽ |
a	 a |
tsṍtcha	 t s õ ́ t c h a |
sũ̀ë	 s ũ ̀ ë |
sĩõ'tãmĩpa	 s ĩ õ ' t ã m ĩ p a |
i'se	 i ' s e |
bitsé	 b i t s é |
darë̀rë̀	 d a r ë ̀ r ë ̀ |
tsé	 t s é |
bitàla	 b i t à l a |
yàrkenẽ	 y à r k e n ẽ |
kók	 k ó k |
pàkuèkenẽ	 p à k u è k e n ẽ |
aí	 a í |
kũẽ̀kèkã	 k ũ ẽ ̀ k è k ã |
wẽ̀	 w ẽ ̀ |
pàkuèke	 p à k u è k e |
shõ̀	 s h õ ̀ |
yë̀nũkã	 y ë ̀ n ũ k ã |
ichàkíule	 i c h à k í u l e |
ishtàwẽ̀mĩ	 i s h t à w ẽ ̀ m ĩ |
sobre	 s o b r e |
kãnẽ̀balö	 k ã n ẽ ̀ b a l ö |
mami	 m a m i |
ishtàwẽ́	 i s h t à w ẽ ́ |
tsë̀ë	 t s ë ̀ ë |
ãjã́	 ã j ã ́ |
ẽẽ	 ẽ ẽ |
wẽlè	 w ẽ l è |
yönẽ	 y ö n ẽ |
kibìie	 k i b ì i e |
ditséwöpa	 d i t s é w ö p a |
shũ̀shã̀	 s h ũ ̀ s h ã ̀ |
ie;	 i e ; |
dë́l	 d ë ́ l |
yë̀bitũ	 y ë ̀ b i t ũ |
mãnẽ̀te	 m ã n ẽ ̀ t e |
kuö̀wö	 k u ö ̀ w ö |
rö̀pakã	 r ö ̀ p a k ã |
kìnẽ	 k ì n ẽ |
káũk	 k á ũ k |
iõiõ̀	 i õ i õ ̀ |
tã́ĩ;	 t ã ́ ĩ ; |
kö̀iè	 k ö ̀ i è |
ar	 a r |
klö̀tsã	 k l ö ̀ t s ã |
dàtsĩ	 d à t s ĩ |
káwẽ́tsã	 k á w ẽ ́ t s ã |
mẽlẽ̀	 m ẽ l ẽ ̀ |
sũwõ'	 s ũ w õ ' |
suwõ'	 s u w õ ' |
kiètã́nẽ	 k i è t ã ́ n ẽ |
yö̀rtã	 y ö ̀ r t ã |
bua'ëmẽ	 b u a ' ë m ẽ |
mũ'	 m ũ ' |
ònẽ	 ò n ẽ |
ditsö̀pa	 d i t s ö ̀ p a |
bitsö̀rö	 b i t s ö ̀ r ö |
dö	 d ö |
lèkã	 l è k ã |
bua'ie	 b u a ' i e |
di	 d i |
dö̀ka	 d ö ̀ k a |
páiki	 p á i k i |
pedro	 p e d r o |
kṍjkẽ̀ẽ	 k õ ́ j k ẽ ̀ ẽ |
yuwák	 y u w á k |
suwànẽ	 s u w à n ẽ |
si	 s i |
yö̀rpa	 y ö ̀ r p a |
yö̀nṍk	 y ö ̀ n õ ́ k |
mĩ́ã	 m ĩ ́ ã |
sa	 s a |
kë́köl	 k ë ́ k ö l |
dö̀mĩ	 d ö ̀ m ĩ |
wéìnẽ	 w é ì n ẽ |
kacha'	 k a c h a ' |
tsũkmĩ	 t s ũ k m ĩ |
kkãmã'	 k k ã m ã ' |
wíbulu	 w í b u l u |
ulíulí	 u l í u l í |
shinõ̀nõ̀	 s h i n õ ̀ n õ ̀ |
tchërala	 t c h ë r a l a |
démĩpa	 d é m ĩ p a |
sklèla	 s k l è l a |
kö́ö	 k ö ́ ö |
""i	 " " i |
katànṍkwã""	 k a t à n õ ́ k w ã " " |
""se'	 " " s e ' |
katànõkwã""	 k a t à n õ k w ã " " |
añĩ̀	 a ñ ĩ ̀ |
dëlë̀r	 d ë l ë ̀ r |
tã́ĩ	 t ã ́ ĩ |
wö̀tö̀ke	 w ö ̀ t ö ̀ k e |
wö̀tö	 w ö ̀ t ö |
ièkã	 i è k ã |
caja	 c a j a |
tsṹmĩ	 t s ũ ́ m ĩ |
wö̀tö́wã	 w ö ̀ t ö ́ w ã |
dikó	 d i k ó |
bikèke	 b i k è k e |
ttö̀ke	 t t ö ̀ k e |
bikö̀ke	 b i k ö ̀ k e |
bikákla	 b i k á k l a |
nãmã̀bita	 n ã m ã ̀ b i t a |
bikö̀mĩ	 b i k ö ̀ m ĩ |
nãñẽ̀e	 n ã ñ ẽ ̀ e |
kã́ñĩ̀nẽ	 k ã ́ ñ ĩ ̀ n ẽ |
mĩ́tchèrak	 m ĩ ́ t c h è r a k |
wẽ́shkètche	 w ẽ ́ s h k è t c h e |
kièrak	 k i è r a k |
""wẽ́shkètche""	 " " w ẽ ́ s h k è t c h e " " |
batörö̀	 b a t ö r ö ̀ |
iõiõ̀ë	 i õ i õ ̀ ë |
mũlũ̀sik	 m ũ l ũ ̀ s i k |
éyök	 é y ö k |
tsa'	 t s a ' |
ták	 t á k |
mẽ̀kã	 m ẽ ̀ k ã |
suítö	 s u í t ö |
suíyö	 s u í y ö |
buèke	 b u è k e |
batsĩ̀	 b a t s ĩ ̀ |
rak	 r a k |
""suítö""	 " " s u í t ö " " |
imã	 i m ã |
nãmã̀bitala	 n ã m ã ̀ b i t a l a |
suí	 s u í |
yàrketche	 y à r k e t c h e |
kulé	 k u l é |
mẽ̀wã	 m ẽ ̀ w ã |
wö̀nĩka	 w ö ̀ n ĩ k a |
ĩ́shẽla	 ĩ ́ s h ẽ l a |
õ̀mĩk	 õ ̀ m ĩ k |
diö́shẽt	 d i ö ́ s h ẽ t |
tchèwã	 t c h è w ã |
aìshẽt	 a ì s h ẽ t |
èköl	 è k ö l |
shũshõ̀	 s h ũ s h õ ̀ |
tchèsẽ	 t c h è s ẽ |
mũlũ̀	 m ũ l ũ ̀ |
tsurúi	 t s u r ú i |
dàtsikètche	 d à t s i k è t c h e |
mẽ̀	 m ẽ ̀ |
kula'	 k u l a ' |
wíñõk	 w í ñ õ k |
èt	 è t |
àtsĩ	 à t s ĩ |
wö̀mãnẽ̀wẽ̀nẽ	 w ö ̀ m ã n ẽ ̀ w ẽ ̀ n ẽ |
wö̀mãnẽ̀wẽ̀ke	 w ö ̀ m ã n ẽ ̀ w ẽ ̀ k e |
wì	 w ì |
àtsẽ	 à t s ẽ |
aìëkã	 a ì ë k ã |
aìẽ	 a ì ẽ |
tsã́	 t s ã ́ |
tékã	 t é k ã |
tsìr	 t s ì r |
bulùbulùë	 b u l ù b u l ù ë |
islẽ́mã	 i s l ẽ ́ m ã |
wö̀mãnẽ̀rkètche	 w ö ̀ m ã n ẽ ̀ r k è t c h e |
mĩkã	 m ĩ k ã |
kë́kölö	 k ë ́ k ö l ö |
katö́	 k a t ö ́ |
chakö́	 c h a k ö ́ |
chakè	 c h a k è |
ñã́	 ñ ã ́ |
otro	 o t r o |
wẽmbrö	 w ẽ m b r ö |
tulur	 t u l u r |
chakö̀	 c h a k ö ̀ |
chakö̀ke	 c h a k ö ̀ k e |
skuée	 s k u é e |
kuö́kĩ	 k u ö ́ k ĩ |
mĩ́tsẽ̀wã	 m ĩ ́ t s ẽ ̀ w ã |
wë́tsë	 w ë ́ t s ë |
mẽ̀mĩ́tsẽ	 m ẽ ̀ m ĩ ́ t s ẽ |
shuwèkèwã	 s h u w è k è w ã |
mẽ̀kèwã	 m ẽ ̀ k è w ã |
ĩ́skĩ	 ĩ ́ s k ĩ |
klö̀ũkwã	 k l ö ̀ ũ k w ã |
klö̀wẽ̀wã	 k l ö ̀ w ẽ ̀ w ã |
íẽrö	 í ẽ r ö |
kö́kã""	 k ö ́ k ã " " |
íes	 í e s |
kö́kã	 k ö ́ k ã |
mṹwã	 m ũ ́ w ã |
diàë́ka	 d i à ë ́ k a |
mẽ́wã	 m ẽ ́ w ã |
suíyök	 s u í y ö k |
rrátkèwãtche	 r r á t k è w ã t c h e |
õ'	 õ ' |
mũẽ̀kèwã	 m ũ ẽ ̀ k è w ã |
sirö̀tak	 s i r ö ̀ t a k |
kàlkicha'	 k à l k i c h a ' |
tsa'kicha'	 t s a ' k i c h a ' |
wíbulula	 w í b u l u l a |
mĩchò	 m ĩ c h ò |
diö́köl	 d i ö ́ k ö l |
tabè	 t a b è |
mẽ̀nẽ̀wa	 m ẽ ̀ n ẽ ̀ w a |
tö̀kĩ	 t ö ̀ k ĩ |
kö́iéulewã	 k ö ́ i é u l e w ã |
kaléũ̀	 k a l é ũ ̀ |
bë́rbëla	 b ë ́ r b ë l a |
kalétsã	 k a l é t s ã |
aísũ	 a í s ũ |
chèkã	 c h è k ã |
kë́chike""	 k ë ́ c h i k e " " |
bitsi'	 b i t s i ' |
kö̀ppée	 k ö ̀ p p é e |
shõ̀ë̀mẽ	 s h õ ̀ ë ̀ m ẽ |
swĩ̀mĩ	 s w ĩ ̀ m ĩ |
kë̀wë̀kala	 k ë ̀ w ë ̀ k a l a |
mẽ́kã	 m ẽ ́ k ã |
tuèke	 t u è k e |
tã́ĩë	 t ã ́ ĩ ë |
kã́wötã	 k ã ́ w ö t ã |
bë̀rëmẽ	 b ë ̀ r ë m ẽ |
yö̀tsã	 y ö ̀ t s ã |
yë́tsã	 y ë ́ t s ã |
kañĩ́kã	 k a ñ ĩ ́ k ã |
iànẽ	 i à n ẽ |
mũẽ̀	 m ũ ẽ ̀ |
batũrèwã	 b a t ũ r è w ã |
tchátche	 t c h á t c h e |
bë̀rë	 b ë ̀ r ë |
ñãlã̀	 ñ ã l ã ̀ |
jkö̀	 j k ö ̀ |
tchörö	 t c h ö r ö |
mẽ̀rkèkã	 m ẽ ̀ r k è k ã |
katà	 k a t à |
balë̀rkètche	 b a l ë ̀ r k è t c h e |
skèkèwã	 s k è k è w ã |
mẽ̀kèiã̀nẽ	 m ẽ ̀ k è i ã ̀ n ẽ |
otra	 o t r a |
wàbale	 w à b a l e |
dë̀dë	 d ë ̀ d ë |
wĩ́ẽrö	 w ĩ ́ ẽ r ö |
baterèwãmĩ	 b a t e r è w ã m ĩ |
dínẽiã	 d í n ẽ i ã |
ulàmẽ̀ule	 u l à m ẽ ̀ u l e |
shkẽ̀rkèkãnẽ	 s h k ẽ ̀ r k è k ã n ẽ |
dalë̀r	 d a l ë ̀ r |
kãnẽ̀wẽ̀ketsã	 k ã n ẽ ̀ w ẽ ̀ k e t s ã |
ã̀s	 ã ̀ s |
ókömpa	 ó k ö m p a |
kë́chikepa	 k ë ́ c h i k e p a |
wĩ́ẽrö;	 w ĩ ́ ẽ r ö ; |
mũk	 m ũ k |
iö̀kwã	 i ö ̀ k w ã |
törö̀kwã	 t ö r ö ̀ k w ã |
teréwã	 t e r é w ã |
balök	 b a l ö k |
ishkẽ̀rkèkã	 i s h k ẽ ̀ r k è k ã |
mẽ́ule	 m ẽ ́ u l e |
iõ̀	 i õ ̀ |
alàralar	 a l à r a l a r |
yö̀nẽbitũ	 y ö ̀ n ẽ b i t ũ |
yu	 y u |
bité	 b i t é |
teré	 t e r é |
wötö́kwã	 w ö t ö ́ k w ã |
ĩ́yök	 ĩ ́ y ö k |
kã́jkẽ	 k ã ́ j k ẽ |
balö̀rö	 b a l ö ̀ r ö |
kã'	 k ã ' |
tèke	 t è k e |
mẽr	 m ẽ r |
kuè	 k u è |
õ̀mĩkã	 õ ̀ m ĩ k ã |
kuèkèwã	 k u è k è w ã |
wanẽ	 w a n ẽ |
tchéwã	 t c h é w ã |
wö̀stéwã	 w ö ̀ s t é w ã |
tká	 t k á |
mĩchö̀ë	 m ĩ c h ö ̀ ë |
ukuö̀k	 u k u ö ̀ k |
ukuè	 u k u è |
kö̀nẽ	 k ö ̀ n ẽ |
skìnẽ	 s k ì n ẽ |
kàlka	 k à l k a |
wö̀nẽ́	 w ö ̀ n ẽ ́ |
tsã̀	 t s ã ̀ |
biökè	 b i ö k è |
kànẽ	 k à n ẽ |
bë́rbër	 b ë ́ r b ë r |
rñẽ́we	 r ñ ẽ ́ w e |
kṍ	 k õ ́ |
ukuö́ũk	 u k u ö ́ ũ k |
wĩ́	 w ĩ ́ |
mĩ̀kèwã	 m ĩ ̀ k è w ã |
kã́	 k ã ́ |
shũshõ̀ë	 s h ũ s h õ ̀ ë |
bö'wö	 b ö ' w ö |
énũĩ̀	 é n ũ ĩ ̀ |
yë́wöla	 y ë ́ w ö l a |
por	 p o r |
eso	 e s o |
ë́l	 ë ́ l |
kuàt	 k u à t |
tché	 t c h é |
lista	 l i s t a |
shũshõ̀la	 s h ũ s h õ ̀ l a |
pákètche	 p á k è t c h e |
mĩ́tche	 m ĩ ́ t c h e |
ukuö́k	 u k u ö ́ k |
làri	 l à r i |
rpànẽ	 r p à n ẽ |
skuè	 s k u è |
ẽ̀nẽ̀wã	 ẽ ̀ n ẽ ̀ w ã |
ã;	 ã ; |
ba	 b a |
bánẽ	 b á n ẽ |
nãñẽ́we	 n ã ñ ẽ ́ w e |
tërkènẽ	 t ë r k è n ẽ |
kapö̀kwã	 k a p ö ̀ k w ã |
tchë́nĩk	 t c h ë ́ n ĩ k |
tchabàtchabàëmẽ	 t c h a b à t c h a b à ë m ẽ |
tsṍli	 t s õ ́ l i |
íe	 í e |
mũẽ̀wã	 m ũ ẽ ̀ w ã |
étchö	 é t c h ö |
ppéũ	 p p é ũ |
chip	 c h i p |
akuö̀k	 a k u ö ̀ k |
wö̀yètse	 w ö ̀ y è t s e |
bulámĩ	 b u l á m ĩ |
akuök	 a k u ö k |
di'bitàã	 d i ' b i t à ã |
tsã́lĩ	 t s ã ́ l ĩ |
akuö̀wẽ̀kenẽ	 a k u ö ̀ w ẽ ̀ k e n ẽ |
bö́iki	 b ö ́ i k i |
mĩtche	 m ĩ t c h e |
mũlũ̀nẽ	 m ũ l ũ ̀ n ẽ |
bë̀rbë̀rala	 b ë ̀ r b ë ̀ r a l a |
wö̀tsée	 w ö ̀ t s é e |
yétsã	 y é t s ã |
nĩẽ́ẽ	 n ĩ ẽ ́ ẽ |
biè	 b i è |
péũ	 p é ũ |
ñẽ̀	 ñ ẽ ̀ |
kèmĩ	 k è m ĩ |
chakö̀mĩ	 c h a k ö ̀ m ĩ |
pẽ́kèwã	 p ẽ ́ k è w ã |
wö̀pẽ́	 w ö ̀ p ẽ ́ |
dulë́dulë	 d u l ë ́ d u l ë |
kuèke	 k u è k e |
bë̀r	 b ë ̀ r |
pòjpò	 p ò j p ò |
õ̀nẽ̀wã	 õ ̀ n ẽ ̀ w ã |
terèwã	 t e r è w ã |
terèkèwã	 t e r è k è w ã |
lbòla	 l b ò l a |
pàterèwãmĩ	 p à t e r è w ã m ĩ |
wa'	 w a ' |
amũ	 a m ũ |
wákapa	 w á k a p a |
bitsö̀	 b i t s ö ̀ |
tã́ĩëmẽ	 t ã ́ ĩ ë m ẽ |
shũ̀	 s h ũ ̀ |
dalë̀rke	 d a l ë ̀ r k e |
sulìsulìla	 s u l ì s u l ì l a |
mmm	 m m m |
ũ̀	 ũ ̀ |
ë̀ka	 ë ̀ k a |
kibì	 k i b ì |
m'm'	 m ' m ' |
aunque	 a u n q u e |
duwö̀mĩ	 d u w ö ̀ m ĩ |
siõ̀rë	 s i õ ̀ r ë |
dalë̀rwã	 d a l ë ̀ r w ã |
ñẽ́rö	 ñ ẽ ́ r ö |
lbó	 l b ó |
yö̀ke	 y ö ̀ k e |
síki	 s í k i |
tchá	 t c h á |
bitséitsè	 b i t s é i t s è |
mĩ́chö̀	 m ĩ ́ c h ö ̀ |
bitsétchö	 b i t s é t c h ö |
páké	 p á k é |
tchátsã	 t c h á t s ã |
ajkuö̀	 a j k u ö ̀ |
klö̀r	 k l ö ̀ r |
klö̀r;	 k l ö ̀ r ; |
ajkuö̀mĩ́tsẽ	 a j k u ö ̀ m ĩ ́ t s ẽ |
pàkö̀rke	 p à k ö ̀ r k e |
pàkuö̀kñã	 p à k u ö ̀ k ñ ã |
wéikèkètche	 w é i k è k è t c h e |
b	 b |
wéikè	 w é i k è |
iö̀kã	 i ö ̀ k ã |
""b	 " " b |
wéikeráwã	 w é i k e r á w ã |
siõ̀dala""	 s i õ ̀ d a l a " " |
wẽ́jkë	 w ẽ ́ j k ë |
siõ̀dala	 s i õ ̀ d a l a |
kũ̀nẽiã""	 k ũ ̀ n ẽ i ã " " |
ñẽ	 ñ ẽ |
kẽ́	 k ẽ ́ |
ñĩ̀ṹknẽ	 ñ ĩ ̀ ũ ́ k n ẽ |
""ẽ'	 " " ẽ ' |
ñĩ̀ṹknẽ""	 ñ ĩ ̀ ũ ́ k n ẽ " " |
pàkuö̀knẽ	 p à k u ö ̀ k n ẽ |
kãñĩ́kã	 k ã ñ ĩ ́ k ã |
wẽ́rö	 w ẽ ́ r ö |
durnẽ	 d u r n ẽ |
kö̀nã̀rpa	 k ö ̀ n ã ̀ r p a |
rà	 r à |
kuö̀mĩ̀nẽ	 k u ö ̀ m ĩ ̀ n ẽ |
pàkö̀nãrmĩ	 p à k ö ̀ n ã r m ĩ |
réwã	 r é w ã |
butùbutùë	 b u t ù b u t ù ë |
kö̀nã̀nẽwã	 k ö ̀ n ã ̀ n ẽ w ã |
kabë̀lapa	 k a b ë ̀ l a p a |
sĩõ̀rë	 s ĩ õ ̀ r ë |
rwö̀	 r w ö ̀ |
tẽr	 t ẽ r |
""kabë̀la	 " " k a b ë ̀ l a |
kṍchök	 k õ ́ c h ö k |
tã""	 t ã " " |
tsìrë	 t s ì r ë |
kuö̀ráã	 k u ö ̀ r á ã |
shkẽ̀rpàkã	 s h k ẽ ̀ r p a ̀ k ã |
mĩ́kã	 m ĩ ́ k ã |
tsö́	 t s ö ́ |
nṹnũ	 n ũ ́ n ũ |
""sítala	 " " s í t a l a |
kobòtala""	 k o b ò t a l a " " |
kö̀rmĩtsẽ	 k ö ̀ r m ĩ t s ẽ |
kö̀rke	 k ö ̀ r k e |
ie'la	 i e ' l a |
ẽ́rdiàrtã	 ẽ ́ r d i à r t ã |
wẽ́ikë	 w ẽ ́ i k ë |
ékapë	 é k a p ë |
""chu	 " " c h u |
kuö́ũ	 k u ö ́ ũ |
ë̀mẽ""	 ë ̀ m ẽ " " |
""tsuru'	 " " t s u r u ' |
klö̀ṹ	 k l ö ̀ ũ ́ |
ñã	 ñ ã |
pàchö̀	 p à c h ö ̀ |
kàlwák	 k à l w á k |
chẽ̀r	 c h ẽ ̀ r |
ã•	 ã • |
tsë̀r	 t s ë ̀ r |
bua'ëtche	 b u a ' ë t c h e |
bitsè	 b i t s è |
kölö́m	 k ö l ö ́ m |
ñẽ̀kũ	 ñ ẽ ̀ k ũ |
ulìtẽnẽ	 u l ì t ẽ n ẽ |
bitsö̀keiã	 b i t s ö ̀ k e i ã |
tchö̀kã	 t c h ö ̀ k ã |
wö̀chika	 w ö ̀ c h i k a |
kàlkuö	 k à l k u ö |
tchékã	 t c h é k ã |
kékã	 k é k ã |
sĩõ̀dala	 s ĩ õ ̀ d a l a |
kĩ́jkẽ	 k ĩ ́ j k ẽ |
ré	 r é |
kë́buklupa	 k ë ́ b u k l u p a |
kièrö	 k i è r ö |
""talàwak""	 " " t a l à w a k " " |
talàwak	 t a l à w a k |
talà	 t a l à |
akë́köl	 a k ë ́ k ö l |
mẽ̀nĩ	 m ẽ ̀ n ĩ |
sulé	 s u l é |
kṍska	 k õ ́ s k a |
diã̀ërö	 d i ã ̀ ë r ö |
rö̀pàkã	 r ö ̀ p a ̀ k ã |
kàchök	 k à c h ö k |
sṹ	 s ũ ́ |
""idèala""	 " " i d è a l a " " |
pàtcháka	 p à t c h á k a |
sũ̀nṍkie	 s ũ ̀ n õ ́ k i e |
pàkë	 p à k ë |
mẽnẽ́t	 m ẽ n ẽ ́ t |
wàbalè	 w à b a l è |
diàẽrö	 d i à ẽ r ö |
wàbalë'	 w à b a l ë ' |
dùwã	 d ù w ã |
nũ̀	 n ũ ̀ |
balë'	 b a l ë ' |
kalö̀õ'	 k a l ö ̀ õ ' |
wẽ̀jkë	 w ẽ ̀ j k ë |
pàtchékã	 p à t c h é k ã |
kũ̀nẽ	 k ũ ̀ n ẽ |
yuwö̀ráã	 y u w ö ̀ r á ã |
rö̀pàkã	 r ö ̀ p à k ã |
idèala	 i d è a l a |
sũ̀nṍk	 s ũ ̀ n õ ́ k |
""sã́ũ	 " " s ã ́ ũ |
durkã""	 d u r k ã " " |
deṹtũ	 d e ũ ́ t ũ |
chiroles	 c h i r o l e s |
tsirìwẽ	 t s i r ì w ẽ |
sẽ́es	 s ẽ ́ e s |
ñẽ̀mĩ	 ñ ẽ ̀ m ĩ |
wéìkö̀ke	 w é ì k ö ̀ k e |
bitsèke	 b i t s è k e |
ahhh	 a h h h |
ujkuèke	 u j k u è k e |
dë̀wã	 d ë ̀ w ã |
ó	 ó |
bitséitsèke	 b i t s é i t s è k e |
ocho	 o c h o |
días	 d í a s |
kàlwö	 k à l w ö |
falta	 f a l t a |
tse	 t s e |
seis	 s e i s |
año	 a ñ o |
kukuö̀ñã	 k u k u ö ̀ ñ ã |
tóto	 t ó t o |
wö́ki	 w ö ́ k i |
diez	 d i e z |
ẽ́r	 ẽ ́ r |
bulùbulùpa	 b u l ù b u l ù p a |
röawá	 r ö a w á |
kalö̀wẽ	 k a l ö ̀ w ẽ |
làrlàrpa	 l à r l à r p a |
èse	 è s e |
iũ̀te	 i ũ ̀ t e |
chénẽ	 c h é n ẽ |
chàkè	 c h à k è |
dónẽ	 d ó n ẽ |
lònẽ;	 l ò n ẽ ; |
papá	 p a p á |
nṹ	 n ũ ́ |
más	 m á s |
seguro	 s e g u r o |
yë́syë̀se	 y ë ́ s y ë ̀ s e |
awápa	 a w á p a |
tãiã;	 t ã i ã ; |
talamanca	 t a l a m a n c a |
iẽ	 i ẽ |
ulìtãnẽ	 u l ì t ã n ẽ |
aja	 a j a |
nãñẽ̀we	 n ã ñ ẽ ̀ w e |
jĩñẽ́itsök	 j ĩ ñ ẽ ́ i t s ö k |
ínẽ	 í n ẽ |
alàr	 a l à r |
lè	 l è |
dóã	 d ó ã |
ttö́dàã	 t t ö ́ d à ã |
brö̀	 b r ö ̀ |
yo	 y o |
sé	 s é |
yö̀nẽ!	 y ö ̀ n ẽ ! |
ja	 j a |
ja…)	 j a … ) |
narciso	 n a r c i s o |
mo	 m o |
morales	 m o r a l e s |
kachìi	 k a c h ì i |
tö̀	 t ö ̀ |
kãnẽ̀balötke	 k ã n ẽ ̀ b a l ö t k e |
duwa'	 d u w a ' |
détsẽ	 d é t s ẽ |
íẽka	 í ẽ k a |
kũẽ́wã	 k ũ ẽ ́ w ã |
lolo	 l o l o |
guabito;	 g u a b i t o ; |
chàke	 c h à k e |
kálök	 k á l ö k |
sulùnẽ̀kã	 s u l ù n ẽ ̀ k ã |
ñẽ'ẽ'	 ñ ẽ ' ẽ ' |
wö̀blaũk	 w ö ̀ b l a ũ k |
ñĩ̀jkë́ë	 ñ ĩ ̀ j k ë ́ ë |
wakè	 w a k è |
kö́nẽ̀ke	 k ö ́ n ẽ ̀ k e |
yö̀rpaiã	 y ö ̀ r p a i ã |
yö̀rmĩĩã	 y ö ̀ r m ĩ ĩ ã |
cara	 c a r a |
i'dë	 i ' d ë |
yö̀nẽĩã	 y ö ̀ n ẽ ĩ ã |
chö̀k	 c h ö ̀ k |
shkál	 s h k á l |
de	 d e |
mayor	 m a y o r |
tãiã	 t ã i ã |
nã́ũyö	 n ã ́ ũ y ö |
dë̀bitũ	 d ë ̀ b i t ũ |
dë̀tsẽ	 d ë ̀ t s ẽ |
tiene	 t i e n e |
cinco	 c i n c o |
años	 a ñ o s |
diàẽ	 d i à ẽ |
uloyo	 u l o y o |
dawö̀chkela	 d a w ö ̀ c h k e l a |
tṹsula	 t ũ ́ s u l a |
dawö̀chke	 d a w ö ̀ c h k e |
narberto	 n a r b e r t o |
dë́ũtu	 d ë ́ ũ t u |
chörà	 c h ö r à |
diö́ẽ	 d i ö ́ ẽ |
chöràla	 c h ö r à l a |
õ̀tẽ	 õ ̀ t ẽ |
shṍböts	 s h õ ́ b ö t s |
mõ̀rmĩ̀nẽ	 m õ ̀ r m ĩ ̀ n ẽ |
dursẽ	 d u r s ẽ |
cuatro	 c u a t r o |
kë́képa	 k ë ́ k é p a |
yuwö̀	 y u w ö ̀ |
iõ̀ka	 i õ ̀ k a |
chakìkã	 c h a k ì k ã |
e'tã;	 e ' t ã ; |
kö̀ök	 k ö ̀ ö k |
sulùsi	 s u l ù s i |
usáwõk	 u s á w õ k |
alàrke	 a l à r k e |
tsök	 t s ö k |
tsèke	 t s è k e |
bikéitsök	 b i k é i t s ö k |
bö́tökicha	 b ö ́ t ö k i c h a |
dalër	 d a l ë r |
kũiã	 k ũ i ã |
wẽ́se	 w ẽ ́ s e |
balo'	 b a l o ' |
kö̀öie	 k ö ̀ ö i e |
láköl	 l á k ö l |
kũṍkĩ	 k ũ õ ́ k ĩ |
bë̀remẽ	 b ë ̀ r e m ẽ |
kĩ́tsèkũ	 k ĩ ́ t s è k ũ |
ètch	 è t c h |
kë̀këpa	 k ë ̀ k ë p a |
mṍũk	 m õ ́ ũ k |
kukuö̀	 k u k u ö ̀ |
mĩ́ãnẽ	 m ĩ ́ ã n ẽ |
""ie'pa	 " " i e ' p a |
kö̀ö	 k ö ̀ ö |
ie'pa""	 i e ' p a " " |
chakì	 c h a k ì |
pàka	 p à k a |
wĩ́kka	 w ĩ ́ k k a |
""ñẽ'	 " " ñ ẽ ' |
mṍũk""	 m õ ́ ũ k " " |
irö́mĩyal	 i r ö ́ m ĩ y a l |
wĩ́es	 w ĩ ́ e s |
mj!	 m j ! |
pë'busi	 p ë ' b u s i |
bë̀riebulu	 b ë ̀ r i e b u l u |
wë́bi	 w ë ́ b i |
sabìr	 s a b ì r |
sulùëmẽ	 s u l ù ë m ẽ |
wèikö̀ke	 w è i k ö ̀ k e |
bikéitsèke	 b i k é i t s è k e |
islèmã	 i s l è m ã |
õ̀rmĩ	 õ ̀ r m ĩ |
bë̀rë;	 b ë ̀ r ë ; |
kùkùnẽ	 k ù k ù n ẽ |
kã́pàkök	 k ã ́ p à k ö k |
suwẽ̀	 s u w ẽ ̀ |
kĩ́tsök	 k ĩ ́ t s ö k |
ë̀k	 ë ̀ k |
chö́	 c h ö ́ |
""ñẽ́es	 " " ñ ẽ ́ e s |
tchërkã	 t c h ë r k ã |
ché""	 c h é " " |
duwè	 d u w è |
ese	 e s e |
kĩ́tsö́	 k ĩ ́ t s ö ́ |
lànẽ	 l à n ẽ |
énũĩ	 é n ũ ĩ |
aahh	 a a h h |
páùtke	 p á ù t k e |
duwás	 d u w á s |
diö̀yànẽ	 d i ö ̀ y à n ẽ |
sku'	 s k u ' |
yawök	 y a w ö k |
ètcha	 è t c h a |
tsìdalala	 t s ì d a l a l a |
ákwö	 á k w ö |
iówã	 i ó w ã |
kichà	 k i c h à |
tsìdala	 t s ì d a l a |
ièka	 i è k a |
tã́nkle	 t ã ́ n k l e |
tsã́tèwã	 t s ã ́ t è w ã |
tsã́te	 t s ã ́ t e |
está	 e s t á |
dalèwã	 d a l è w ã |
íkke	 í k k e |
ya'	 y a ' |
kañĩ́k	 k a ñ ĩ ́ k |
sùnẽ	 s ù n ẽ |
dö̀wãmĩ	 d ö ̀ w ã m ĩ |
dö̀tã	 d ö ̀ t ã |
momento	 m o m e n t o |
tchõ'	 t c h õ ' |
""ísã	 " " í s ã |
kapi""	 k a p i " " |
kapi	 k a p i |
dikóchka	 d i k ó c h k a |
ilèe	 i l è e |
iõ̀kĩ	 i õ ̀ k ĩ |
tchã'	 t c h ã ' |
chö́wẽ̀kèwã	 c h ö ́ w ẽ ̀ k è w ã |
kabènẽ	 k a b è n ẽ |
""s	 " " s |
kë́köl""	 k ë ́ k ö l " " |
dé;	 d é ; |
tsṍlĩkö	 t s õ ́ l ĩ k ö |
dakrò	 d a k r ò |
sarùrù	 s a r ù r ù |
lèkètche	 l è k è t c h e |
kukuèke	 k u k u è k e |
wõwṍnẽla	 w õ w õ ́ n ẽ l a |
bàwẽ	 b à w ẽ |
rñẽ́wẽ	 r ñ ẽ ́ w ẽ |
íkkëtã	 í k k ë t ã |
wö̀të́nẽwã	 w ö ̀ t ë ́ n ẽ w ã |
nãñẽ́wekö	 n ã ñ ẽ ́ w e k ö |
ñĩ́wek	 ñ ĩ ́ w e k |
kë́wë	 k ë ́ w ë |
balë̀nẽ̀wã	 b a l ë ̀ n ẽ ̀ w ã |
nãmã́söl	 n ã m ã ́ s ö l |
yi	 y i |
aláralar	 a l á r a l a r |
dó	 d ó |
tsũk	 t s ũ k |
dá	 d á |
mẽ́	 m ẽ ́ |
yànẽtche	 y à n ẽ t c h e |
yúshka	 y ú s h k a |
bayö̀balö́	 b a y ö ̀ b a l ö ́ |
e'ã	 e ' ã |
kèrwa	 k è r w a |
wébalè	 w é b a l è |
""i'	 " " i ' |
si'	 s i ' |
kã́ñĩ̀nẽ""	 k ã ́ ñ ĩ ̀ n ẽ " " |
wö̀mũ̀ke	 w ö ̀ m ũ ̀ k e |
wö̀mũkèwã""	 w ö ̀ m ũ k è w ã " " |
rpágala	 r p á g a l a |
chàké	 c h à k é |
wë̀nẽ	 w ë ̀ n ẽ |
bö̀t	 b ö ̀ t |
mãñã̀t	 m ã ñ ã ̀ t |
kã́ñìrke""	 k ã ́ ñ ì r k e " " |
wa;	 w a ; |
èk	 è k |
dö̀ppa	 d ö ̀ p p a |
wö̀mũkèwã	 w ö ̀ m ũ k e ̀ w ã |
sĩõ	 s ĩ õ |
'	 ' |
kalö̀nẽ	 k a l ö ̀ n ẽ |
bua'nẽiãnẽ	 b u a ' n ẽ i ã n ẽ |
yulë́la	 y u l ë ́ l a |
bua'rmĩnẽ	 b u a ' r m ĩ n ẽ |
bua'rdànẽ	 b u a ' r d à n ẽ |
rö;	 r ö ; |
kã́bata	 k ã ́ b a t a |
sĩ	 s ĩ |
bayö̀balé	 b a y ö ̀ b a l é |
tö̀kkã	 t ö ̀ k k ã |
tö̀tché	 t ö ̀ t c h é |
tétsã	 t é t s ã |
una	 u n a |
uuu	 u u u |
íjketã	 í j k e t ã |
wö̀të̀nẽtche	 w ö ̀ t ë ̀ n ẽ t c h e |
ẽ̀nĩõõ	 ẽ ̀ n ĩ õ õ |
wö̀të̀nẽwã	 w ö ̀ t ë ̀ n ẽ w ã |
kö̀ièwã	 k ö ̀ i è w ã |
chamũ̀	 c h a m ũ ̀ |
mĩ	 m ĩ |
sũ̀nẽ	 s ũ ̀ n ẽ |
wö̀uk	 w ö ̀ u k |
tsẽ̀keãt	 t s ẽ ̀ k e ã t |
kṍkö	 k õ ́ k ö |
tskurík	 t s k u r í k |
tṍ	 t õ ́ |
mẽrkã	 m ẽ r k ã |
diàse	 d i à s e |
kuwö̀̀	 k u w ö ̀ ̀ |
kuwö̀	 k u w ö ̀ |
lö́lö	 l ö ́ l ö |
kuö̀ë	 k u ö ̀ ë |
bö́	 b ö ́ |
jkö	 j k ö |
ñã́wẽ̀kètche	 ñ ã ́ w ẽ ̀ k è t c h e |
wö̀teulewã	 w ö ̀ t e u l e w ã |
tsĩ̀	 t s ĩ ̀ |
tak	 t a k |
ñã́wẽ̀ke	 ñ ã ́ w ẽ ̀ k e |
bukula'	 b u k u l a ' |
ùjkuö	 ù j k u ö |
èkapë;	 è k a p ë ; |
dalë̀nẽ	 d a l ë ̀ n ẽ |
yulèk	 y u l è k |
e	 e |
yölö̀nṍk	 y ö l ö ̀ n õ ́ k |
kapö̀	 k a p ö ̀ |
dölö̀	 d ö l ö ̀ |
bitsö̀mĩ	 b i t s ö ̀ m ĩ |
ñĩ̀ĩ̀ĩ̀	 ñ ĩ ̀ ĩ ̀ ĩ ̀ |
ppèkènẽ	 p p è k è n ẽ |
ma	 m a |
tũ̀m	 t ũ ̀ m |
kata'	 k a t a ' |
bikèwã	 b i k è w ã |
mũ̀	 m ũ ̀ |
kukõ'	 k u k õ ' |
pṹ	 p ũ ́ |
tsã́téwã	 t s ã ́ t é w ã |
íjkëla	 í j k ë l a |
íjkela;	 í j k e l a ; |
iékã	 i é k ã |
pèkènẽ	 p è k è n ẽ |
tsĩ	 t s ĩ |
skli	 s k l i |
tsã́kuée	 t s ã ́ k u é e |
bitsö̀wẽ̀ke	 b i t s ö ̀ w ẽ ̀ k e |
ñĩ̀ë	 ñ ĩ ̀ ë |
diö̀yö	 d i ö ̀ y ö |
suu	 s u u |
chö́kela	 c h ö ́ k e l a |
wö̀tërulèwã	 w ö ̀ t ë r u l è w ã |
distéwö	 d i s t é w ö |
íjketcha	 í j k e t c h a |
etch	 e t c h |
kṍrkĩ	 k õ ́ r k ĩ |
yuwèkã	 y u w è k ã |
iõ̀kã	 i õ ̀ k ã |
dóyal	 d ó y a l |
kèke	 k è k e |
kiöktsã	 k i ö k t s ã |
sulĩ̀	 s u l ĩ ̀ |
kièkètsã	 k i è k è t s ã |
mõnẽ̀tche	 m õ n ẽ ̀ t c h e |
kiök	 k i ö k |
wẽ́jkëtã	 w ẽ ́ j k ë t ã |
tö̀tchètsã	 t ö ̀ t c h è t s ã |
kũẽ̀ppa	 k ũ ẽ ̀ p p a |
ièã	 i è ã |
ièmĩ̀kã	 i è m ĩ ̀ k ã |
ièppakã	 i è p p a k ã |
́ĩ	 ́ ĩ |
tṹr	 t ũ ́ r |
bulámĩkö	 b u l á m ĩ k ö |
kũẽ̀wã	 k ũ ẽ ̀ w ã |
duwö́wã	 d u w ö ́ w ã |
õ̀n	 õ ̀ n |
të̀nẽ̀wã	 t ë ̀ n ẽ ̀ w ã |
bitèanẽ	 b i t è a n ẽ |
kàle	 k à l e |
tsẽ́mĩ	 t s ẽ ́ m ĩ |
rwó	 r w ó |
du'	 d u ' |
síwẽ̀mĩ	 s í w ẽ ̀ m ĩ |
tsã́kã	 t s ã ́ k ã |
síwẽ̀ppa	 s í w ẽ ̀ p p a |
e'ñẽ́rmã	 e ' ñ ẽ ́ r m ã |
sũwẽ́tche	 s ũ w ẽ ́ t c h e |
ewa	 e w a |
wö̀káwẽ	 w ö ̀ k á w ẽ |
kö̀kã	 k ö ̀ k ã |
sërërërërë	 s ë r ë r ë r ë r ë |
bua'ë!	 b u a ' ë ! |
kũẽ̀rà	 k ũ ẽ ̀ r à |
yú	 y ú |
sã́ũk	 s ã ́ ũ k |
mĩ́tsẽ	 m ĩ ́ t s ẽ |
biètsã	 b i è t s ã |
kũẽ̀	 k ũ ẽ ̀ |
síwẽ̀ke	 s í w ẽ ̀ k e |
dalèkua	 d a l è k u a |
tsébita	 t s é b i t a |
mũlũ̀lka	 m ũ l ũ ̀ l k a |
wö̀ñẽkètche	 w ö ̀ ñ ẽ k è t c h e |
mĩ́r	 m ĩ ́ r |
ë̀;	 ë ̀ ; |
yuwö̀keiã	 y u w ö ̀ k e i ã |
là	 l à |
wẽ́ri	 w ẽ ́ r i |
yànṍk	 y à n õ ́ k |
ñẽ́ẽrönẽ	 ñ ẽ ́ ẽ r ö n ẽ |
también	 t a m b i é n |
mẽ̀kètche;	 m ẽ ̀ k è t c h e ; |
ulàmẽ	 u l à m ẽ |
dàtsĩkenẽ	 d à t s ĩ k e n ẽ |
bitsök	 b i t s ö k |
wĩ̀ẽrö	 w ĩ ̀ ẽ r ö |
wẽ́̀	 w ẽ ́ ̀ |
ñĩ̀köl	 ñ ĩ ̀ k ö l |
ñĩ̀wẽ	 ñ ĩ ̀ w ẽ |
dapàrke	 d a p à r k e |
yö́kĩ	 y ö ́ k ĩ |
wö̀li	 w ö ̀ l i |
wõwṍ	 w õ w õ ́ |
lìrke	 l ì r k e |
katèkètche	 k a t è k è t c h e |
skíke	 s k í k e |
katé	 k a t é |
skíkanẽ	 s k í k a n ẽ |
katànẽ	 k a t à n ẽ |
áù	 á ù |
awé	 a w é |
sulùrkèwã	 s u l ù r k è w ã |
mẽ̀rkèwã	 m ẽ ̀ r k è w ã |
talvez	 t a l v e z |
shkákle	 s h k á k l e |
kàlkicha	 k à l k i c h a |
bayö̀blák	 b a y ö ̀ b l á k |
cherà	 c h e r à |
shkák	 s h k á k |
bakë̀nẽ	 b a k ë ̀ n ẽ |
sulùwẽ	 s u l ù w ẽ |
wẽ́jkëlè	 w ẽ ́ j k ë l è |
wẽ́jkële	 w ẽ ́ j k ë l e |
chebo	 c h e b o |
wéìr	 w é ì r |
sulùõwã	 s u l ù õ w ã |
làr	 l à r |
ñẽ́se	 ñ ẽ ́ s e |
sulùnẽ̀wã	 s u l ù n ẽ ̀ w ã |
chówã	 c h ó w ã |
verdad	 v e r d a d |
ahh	 a h h |
bikèitsèmĩ	 b i k è i t s è m ĩ |
ètk	 è t k |
shṹulat	 s h ũ ́ u l a t |
wìwö	 w ì w ö |
