Ndaipotái	 N d a i p o t á i |
che	 c h e |
upéva.	 u p é v a . |
Ahechava'erã	 A h e c h a v a ' e r ã |
sapatu	 s a p a t u |
ohóva	 o h ó v a |
traje-re.	 t r a j e - r e . |
Tekokatu	 T e k o k a t u |
térã	 t é r ã |
tekomarã	 t e k o m a r ã |
heñói	 h e ñ ó i |
ndénte	 n d é n t e |
reipotágui	 r e i p o t á g u i |
Hóga	 H ó g a |
rape	 r a p e |
yke	 y k e |
akatúa	 a k a t ú a |
gotyo	 g o t y o |
ndaje	 n d a j e |
ojogapo	 o j o g a p o |
karai	 k a r a i |
Crispín.	 C r i s p í n . |
Ha'éniko	 H a ' é n i k o |
ndogueroviái	 n d o g u e r o v i á i |
ko'ã	 k o ' ã |
mba'e.	 m b a ' e . |
Ñane	 Ñ a n e |
ã	 ã |
ombojajái	 o m b o j a j á i |
Aháta	 A h á t a |
amba'apo.	 a m b a ' a p o . |
Ombouva'ekue	 O m b o u v a ' e k u e |
heta	 h e t a |
ñorairõhára.	 ñ o r a i r õ h á r a . |
Amóntema	 A m ó n t e m a |
upéicharõ.	 u p é i c h a r õ . |
Mokõive	 M o k õ i v e |
ndogueroviaséi	 n d o g u e r o v i a s é i |
upe	 u p e |
mba'e	 m b a ' e |
ojehuva'ekue.	 o j e h u v a ' e k u e . |
ha	 h a |
ojeromandu'a	 o j e r o m a n d u ' a |
umi	 u m i |
pokõi	 p o k õ i |
ñe'ẽ	 ñ e ' ẽ |
he'iva'ekue	 h e ' i v a ' e k u e |
Ajúngo	 A j ú n g o |
aipo	 a i p o |
concurso-hápe	 c o n c u r s o - h á p e |
Avy'a	 A v y ' a |
roikuaahaguére.	 r o i k u a a h a g u é r e . |
Ndatuicháiniko	 N d a t u i c h á i n i k o |
itapỹi.	 i t a p ỹ i . |
Mba'épa	 M b a ' é p a |
he'ise.	 h e ' i s e . |
Ndaipirapirevéi.	 N d a i p i r a p i r e v é i . |
Mboy	 M b o y |
avápa	 a v á p a |
oñe'ẽ.	 o ñ e ' ẽ . |
Ha	 H a |
epoi	 e p o i |
chugui	 c h u g u i |
okaru	 o k a r u |
hag̃ua.	 h a g ̃ u a . |
nde	 n d e |
reipytyvõva'erã	 r e i p y t y v õ v a ' e r ã |
ichupe.	 i c h u p e . |
ára	 á r a |
peteĩháme	 p e t e ĩ h á m e |
ombosako'íva	 o m b o s a k o ' í v a |
tembi'u	 t e m b i ' u |
asajegua	 a s a j e g u a |
Ndahaʼéikuri	 N d a h a ʼ é i k u r i |
tekove	 t e k o v e |
porã.	 p o r ã . |
Upémarõ	 U p é m a r õ |
he'i	 h e ' i |
mozo-pe.	 m o z o - p e . |
ha'éva	 h a ' é v a |
tembi'umi	 t e m b i ' u m i |
terere	 t e r e r e |
mboyvegua.	 m b o y v e g u a . |
Opirakutu	 O p i r a k u t u |
ýpe.	 ý p e . |
Mba'éiko	 M b a ' é i k o |
kuarahy	 k u a r a h y |
Arakuéra.	 A r a k u é r a . |
Avei	 A v e i |
tembiʼu	 t e m b i ʼ u |
koʼẽngue	 k o ʼ ẽ n g u e |
ojekuaavéva	 o j e k u a a v é v a |
ype	 y p e |
rovápe.	 r o v á p e . |
Oñopehẽngue	 O ñ o p e h ẽ n g u e |
mokõi	 m o k õ i |
kuña	 k u ñ a |
ndaikatúiva	 n d a i k a t ú i v a |
ojoko	 o j o k o |
juru.	 j u r u . |
ha'ejey	 h a ' e j e y |
chejupe.	 c h e j u p e . |
Umi	 U m i |
kaʼatýre	 k a ʼ a t ý r e |
ndouveihag̃uáma.	 n d o u v e i h a g ̃ u á m a . |
nereiméi	 n e r e i m é i |
Che	 C h e |
chipa	 c h i p a |
la	 l a |
hevéva.	 h e v é v a . |
Hilario	 H i l a r i o |
katu	 k a t u |
ojuhúkuri	 o j u h ú k u r i |
irundy	 i r u n d y |
hymba	 h y m b a |
vaka	 v a k a |
oñekarãi	 o ñ e k a r ã i |
huguypáva.	 h u g u y p á v a . |
Ojeroviaitereígui	 O j e r o v i a i t e r e í g u i |
ijehe	 i j e h e |
Chavuku	 C h a v u k u |
nohenduvéi	 n o h e n d u v é i |
Tuvichavetépe	 T u v i c h a v e t é p e |
Kuñakarai	 K u ñ a k a r a i |
omaña	 o m a ñ a |
imemby'i	 i m e m b y ' i |
pahaguére	 p a h a g u é r e |
Tuichaitereíngo	 T u i c h a i t e r e í n g o |
roñemondýi.	 r o ñ e m o n d ý i . |
oĩ	 o ĩ |
ñarambosa	 ñ a r a m b o s a |
Yvypóra	 Y v y p ó r a |
ñemongaru.	 ñ e m o n g a r u . |
Peteĩ	 P e t e ĩ |
oñorairõmbaguasúkuri.	 o ñ o r a i r õ m b a g u a s ú k u r i . |
py'ỹinte	 p y ' ỹ i n t e |
mokõivéva	 m o k õ i v é v a |
ohomiva'erã	 o h o m i v a ' e r ã |
jerokyhápe	 j e r o k y h á p e |
hamba'e.	 h a m b a ' e . |
Ani	 A n i |
rembohovái	 r e m b o h o v á i |
pévango	 p é v a n g o |
Malavisiõ	 M a l a v i s i õ |
oúta	 o ú t a |
ñandéve.	 ñ a n d é v e . |
Mbohapy	 M b o h a p y |
mitã	 m i t ã |
jeko	 j e k o |
oguereko.	 o g u e r e k o . |
Hembiapokuéra	 H e m b i a p o k u é r a |
ñemohu'ã.	 ñ e m o h u ' ã . |
Terehómake	 T e r e h ó m a k e |
chéve	 c h é v e |
ko'águi.	 k o ' á g u i . |
Upéi	 U p é i |
oñembyatypa	 o ñ e m b y a t y p a |
oñemboʼe	 o ñ e m b o ʼ e |
omomorã	 o m o m o r ã |
kurusúpe.	 k u r u s ú p e . |
Omoñarõ	 O m o ñ a r õ |
tóro	 t ó r o |
morotĩ	 m o r o t ĩ |
Kuatiakatu	 K u a t i a k a t u |
iporãva.	 i p o r ã v a . |
Ohasa	 O h a s a |
rire	 r i r e |
peteĩ	 p e t e ĩ |
aravo	 a r a v o |
niko,	 n i k o , |
opu'ã	 o p u ' ã |
he'i.	 h e ' i . |
Tavaygua	 T a v a y g u a |
hekorã	 h e k o r ã |
peikotevẽmi	 p e i k o t e v ẽ m i |
pejúvo.	 p e j ú v o . |
arýpa	 a r ý p a |
rereko.	 r e r e k o . |
Ava	 A v a |
mymba	 m y m b a |
tekorenda.	 t e k o r e n d a . |
Upéingo	 U p é i n g o |
ohasáma	 o h a s á m a |
mozo	 m o z o |
ndoguerúi	 n d o g u e r ú i |
chupe	 c h u p e |
pe	 p e |
ojeruréva.	 o j e r u r é v a . |
Uperiremínte	 U p e r i r e m í n t e |
g̃uaig̃uimi	 g ̃ u a i g ̃ u i m i |
oipe'a	 o i p e ' a |
oga'i	 o g a ' i |
rokẽ	 r o k ẽ |
Mmm,	 M m m , |
ko	 k o |
ho’ysã	 h o ’ y s ã |
Mávapa	 M á v a p a |
mbaʼe	 m b a ʼ e |
ipuʼakapáva	 i p u ʼ a k a p á v a |
yvórape?	 y v ó r a p e ? |
Ikatuha	 I k a t u h a |
peve	 p e v e |
ahejánte	 a h e j á n t e |
chupe.	 c h u p e . |
Ovákuri	 O v á k u r i |
ipehẽnguekuéra	 i p e h ẽ n g u e k u é r a |
ndive	 n d i v e |
Táva	 T á v a |
Paraguaýpe.	 P a r a g u a ý p e . |
Kuimba'e	 K u i m b a ' e |
oikóva	 o i k ó v a |
pynandi,	 p y n a n d i , |
hovasy	 h o v a s y |
oñemonde	 o ñ e m o n d e |
Paraguáiva.	 P a r a g u á i v a . |
Ohopámapiko.	 O h o p á m a p i k o . |
Ndekyra.	 N d e k y r a . |
Uruku	 U r u k u |
peipurúta	 p e i p u r ú t a |
avei	 a v e i |
pembosa'y	 p e m b o s a ' y |
hag̃ua	 h a g ̃ u a |
pytãme	 p y t ã m e |
pende	 p e n d e |
aokuéra	 a o k u é r a |
Hembiapokue	 H e m b i a p o k u e |
ypy.	 y p y . |
Ñepyrũrãme	 Ñ e p y r ũ r ã m e |
ndaheraivaʼekue.	 n d a h e r a i v a ʼ e k u e . |
upépe	 u p é p e |
oĩjepe	 o ĩ j e p e |
Academia	 A c a d e m i a |
Literaria-pe	 L i t e r a r i a - p e |
Romaña	 R o m a ñ a |
porã	 p o r ã |
ojuehe	 o j u e h e |
noroñe'ẽi	 n o r o ñ e ' ẽ i |
ojupe.	 o j u p e . |
Nachemandu'ái.	 N a c h e m a n d u ' á i . |
Ohepyme'ẽ	 O h e p y m e ' ẽ |
Oipuru	 O i p u r u |
hikuái	 h i k u á i |
ka'a	 k a ' a |
ho'u	 h o ' u |
terere.	 t e r e r e . |
Ore	 O r e |
rostudiáta	 r o s t u d i á t a |
luneskue.	 l u n e s k u e . |
Mbaʼépa	 M b a ʼ é p a |
pehendúne	 p e h e n d ú n e |
lugarpe.	 l u g a r p e . |
ñanembopyʼaroryvéva?	 ñ a n e m b o p y ʼ a r o r y v é v a ? |
Omosã	 O m o s ã |
mbaʼekuaa.	 m b a ʼ e k u a a . |
Ko'ã	 K o ' ã |
caja-pe	 c a j a - p e |
areko	 a r e k o |
tuja	 t u j a |
ndaipotavéima.	 n d a i p o t a v é i m a . |
Péa	 P é a |
ha'e.	 h a ' e . |
Mba'épiko	 M b a ' é p i k o |
chéve.	 c h é v e . |
Aikéma	 A i k é m a |
korapýpe.	 k o r a p ý p e . |
Napépe	 N a p é p e |
rajy	 r a j y |
Princesa.	 P r i n c e s a . |
ohasaha	 o h a s a h a |
rupi	 r u p i |
ñavõ	 ñ a v õ |
Prudencio	 P r u d e n c i o |
Añetépa	 A ñ e t é p a |
ere	 e r e |
Pehasa	 P e h a s a |
opa	 o p a |
iporãva	 i p o r ã v a |
ivaíva	 i v a í v a |
Tata	 T a t a |
guasu	 g u a s u |
opu'ãvo	 o p u ' ã v o |
ojahéi	 o j a h é i |
tekoháre	 t e k o h á r e |
Upéima	 U p é i m a |
niko	 n i k o |
ñaimo'ã	 ñ a i m o ' ã |
ku	 k u |
añeñandujeýva.	 a ñ e ñ a n d u j e ý v a . |
Ohecha	 O h e c h a |
mba'éichapa	 m b a ' é i c h a p a |
ha'e	 h a ' e |
oñemboja	 o ñ e m b o j a |
oike	 o i k e |
ra'y	 r a ' y |
yno'õme.	 y n o ' õ m e . |
Ñande	 Ñ a n d e |
mboriahúko	 m b o r i a h ú k o |
nañandepo'aivavoi	 n a ñ a n d e p o ' a i v a v o i |
ohoreíma	 o h o r e í m a |
heseve.	 h e s e v e . |
Opa	 O p a |
mba'ére	 m b a ' é r e |
tapichakuéra	 t a p i c h a k u é r a |
ohayhu	 o h a y h u |
ndaipóri	 n d a i p ó r i |
yvy	 y v y |
ome'ẽ'aréva	 o m e ' ẽ ' a r é v a |
hi'a	 h i ' a |
Aravo	 A r a v o |
ojeike	 o j e i k e |
haguã.	 h a g u ã . |
Oiméne	 O i m é n e |
kóva	 k ó v a |
hína	 h í n a |
Pláta	 P l á t a |
Yvyguy	 Y v y g u y |
upéicha	 u p é i c h a |
ndoipotaiete	 n d o i p o t a i e t e |
oñe'ẽ	 o ñ e ' ẽ |
kuimba'ekuéra	 k u i m b a ' e k u é r a |
ndive.	 n d i v e . |
Omyasãi	 O m y a s ã i |
yvoty	 y v o t y |
ryakuãvu	 r y a k u ã v u |
Hũngy	 H ũ n g y |
morotĩ.	 m o r o t ĩ . |
Eñeha'ãke	 E ñ e h a ' ã k e |
akói	 a k ó i |
eiko	 e i k o |
teko	 t e k o |
potĩme	 p o t ĩ m e |
Upeichavérõ	 U p e i c h a v é r õ |
jepe	 j e p e |
ndoúi	 n d o ú i |
ha	 h a |
ndohói	 n d o h ó i |
Kalo'ípe.	 K a l o ' í p e . |
Mba'érepa	 M b a ' é r e p a |
ogueraha	 o g u e r a h a |
mba'ehe'ẽ	 m b a ' e h e ' ẽ |
ijarýipe.	 i j a r ý i p e . |
Ha	 H a |
mba'e	 m b a ' e |
jajapóta	 j a j a p ó t a |
ñande.	 ñ a n d e . |
Péichantema	 P é i c h a n t e m a |
opyta	 o p y t a |
hikuái.	 h i k u á i . |
Omombe'u	 O m o m b e ' u |
mba'éichapa	 m b a ' é i c h a p a |
heñói	 h e ñ ó i |
iñapysẽkuri	 i ñ a p y s ẽ k u r i |
ko	 k o |
aranduka.	 a r a n d u k a . |
Chekuerái.	 C h e k u e r á i . |
Yvágagui	 Y v á g a g u i |
rejúva	 r e j ú v a |
Ojeruremavoíkuri	 O j e r u r e m a v o í k u r i |
hikuái	 h i k u á i |
peteĩ	 p e t e ĩ |
Léi	 L é i |
Guasu.	 G u a s u . |
Yvyrapã	 Y v y r a p ã |
ojapo	 o j a p o |
guajayvígui.	 g u a j a y v í g u i . |
Pe	 P e |
vy'a	 v y ' a |
ndahi'aréi	 n d a h i ' a r é i |
Pukavy	 P u k a v y |
pa'ũme	 p a ' ũ m e |
japáy	 j a p á y |
ñapu'ã.	 ñ a p u ' ã . |
Pyharepyte	 P y h a r e p y t e |
riregua	 r i r e g u a |
niko.	 n i k o . |
Upeichaite	 U p e i c h a i t e |
jekorakaʼe	 j e k o r a k a ʼ e |
ojehúkuri.	 o j e h ú k u r i . |
Ag̃ave	 A g ̃ a v e |
rohóta	 r o h ó t a |
ropurahéi	 r o p u r a h é i |
chupe.	 c h u p e . |
Kuarahy	 K u a r a h y |
ojope	 o j o p e |
Chopombe	 C h o p o m b e |
ndaje	 n d a j e |
imitã	 i m i t ã |
guive	 g u i v e |
oñangarekova'ekue	 o ñ a n g a r e k o v a ' e k u e |
Ña	 Ñ a |
Antonia-re.	 A n t o n i a - r e . |
nde?	 n d e ? |
Okyvérõnteke	 O k y v é r õ n t e k e |
okyvehína.	 o k y v e h í n a . |
Mba'éichapa	 M b a ' é i c h a p a |
umi	 u m i |
jagua	 j a g u a |
saite	 s a i t e |
ho'u	 h o ' u |
ivurromíme.	 i v u r r o m í m e . |
Isy	 I s y |
ohogue'ómiva'erã	 o h o g u e ' ó m i v a ' e r ã |
hetyma	 h e t y m a |
heviro'óre	 h e v i r o ' ó r e |
typycha	 t y p y c h a |
hũ.	 h ũ . |
Amombe'uporãta	 A m o m b e ' u p o r ã t a |
ndéve	 n d é v e |
reg̃uahẽkuaa	 r e g ̃ u a h ẽ k u a a |
ore	 o r e |
rogamíme.	 r o g a m í m e . |
Oiko	 O i k o |
ka'aguýre.	 k a ' a g u ý r e . |
Omoñaniseveseve	 O m o ñ a n i s e v e s e v e |
hymba	 h y m b a |
kavajukuéra.	 k a v a j u k u é r a . |
Peteĩ	 P e t e ĩ |
guasu	 g u a s u |
ra'ymi	 r a ' y m i |
mokõi	 m o k õ i |
kakuaáva.	 k a k u a á v a . |
kuña	 k u ñ a |
arandu	 a r a n d u |
omotenonde	 o m o t e n o n d e |
omomombaretéva	 o m o m o m b a r e t é v a |
ñane	 ñ a n e |
retã	 r e t ã |
Kuimbaʼe	 K u i m b a ʼ e |
katupyry	 k a t u p y r y |
ombaʼapóva	 o m b a ʼ a p ó v a |
ikokuépe.	 i k o k u é p e . |
Araka'eve	 A r a k a ' e v e |
jeko	 j e k o |
ndojehúi	 n d o j e h ú i |
chupe	 c h u p e |
itajyramíme	 i t a j y r a m í m e |
mba'eve	 m b a ' e v e |
ivaíva.	 i v a í v a . |
Tapicha	 T a p i c h a |
hetãrayhúva	 h e t ã r a y h ú v a |
ho'a	 h o ' a |
ñuhã	 ñ u h ã |
guasúpe	 g u a s ú p e |
Avy'aitépa	 A v y ' a i t é p a |
upéicharõ	 u p é i c h a r õ |
Guarani	 G u a r a n i |
ñe'ẽténte	 ñ e ' ẽ t é n t e |
ojepuru.	 o j e p u r u . |
Anatápente	 A n a t á p e n t e |
ojekuaavéva.	 o j e k u a a v é v a . |
Mba'érepiko	 M b a ' é r e p i k o |
reñemomombyryete	 r e ñ e m o m o m b y r y e t e |
orehegui.	 o r e h e g u i . |
Umi	 U m i |
mbaʼe	 m b a ʼ e |
ohesy	 o h e s y |
tatápe.	 t a t á p e . |
Ma'erãpiko	 M a ' e r ã p i k o |
ñañemoakãrasýta	 ñ a ñ e m o a k ã r a s ý t a |
Vy'apópe	 V y ' a p ó p e |
oikókuri	 o i k ó k u r i |
oñondive.	 o ñ o n d i v e . |
opavave	 o p a v a v e |
ijaty	 i j a t y |
tupãópe	 t u p ã ó p e |
omongaraívo	 o m o n g a r a í v o |
pindo	 p i n d o |
ojejapóva	 o j e j a p ó v a |
ogapýpe	 o g a p ý p e |
Chéveramo	 C h é v e r a m o |
g̃uarã	 g ̃ u a r ã |
ahechahague	 a h e c h a h a g u e |
jaguarete	 j a g u a r e t e |
og̃uahẽvo	 o g ̃ u a h ẽ v o |
mbokaja	 m b o k a j a |
tuja	 t u j a |
renondépe.	 r e n o n d é p e . |
upéicha	 u p é i c h a |
che	 c h e |
irũnguéra.	 i r ũ n g u é r a . |
Upéicha	 U p é i c h a |
avei	 a v e i |
oisãmbyhy	 o i s ã m b y h y |
kuatiahaipyre	 k u a t i a h a i p y r e |
itavapegua.	 i t a v a p e g u a . |
Néi,	 N é i , |
aháta	 a h á t a |
nendive.	 n e n d i v e . |
oikojeýkuri	 o i k o j e ý k u r i |
pyhare.	 p y h a r e . |
Ndaikatuvéima	 N d a i k a t u v é i m a |
ojejapo	 o j e j a p o |
hese	 h e s e |
mbaʼeve.	 m b a ʼ e v e . |
Onohẽmbaitékuri	 O n o h ẽ m b a i t é k u r i |
karai	 k a r a i |
kurusu	 k u r u s u |
ojuhúva	 o j u h ú v a |
hapépe.	 h a p é p e . |
oikóva	 o i k ó v a |
ambue	 a m b u e |
táva	 t á v a |
rupi	 r u p i |
Ajetepyso	 A j e t e p y s o |
asẽ	 a s ẽ |
korapýpe.	 k o r a p ý p e . |
Mborayhu	 M b o r a y h u |
ijapyra'ỹva	 i j a p y r a ' ỹ v a |
Iñirũnguéra	 I ñ i r ũ n g u é r a |
niko	 n i k o |
ohupi	 o h u p i |
ijyva	 i j y v a |
ári.	 á r i . |
Mávapa	 M á v a p a |
mboʼehára	 m b o ʼ e h á r a |
ikatupyryvéva?	 i k a t u p y r y v é v a ? |
Mba'eichahápepiko	 M b a ' e i c h a h á p e p i k o |
oiko	 o i k o |
nderehe	 n d e r e h e |
upéva.	 u p é v a . |
Heko.	 H e k o . |
Mano	 M a n o |
Teʼõnguekuaaty	 T e ʼ õ n g u e k u a a t y |
Ayvureko	 A y v u r e k o |
rehe.	 r e h e . |
Ary	 A r y |
Pyahúpe.	 P y a h ú p e . |
Ndahaʼéi	 N d a h a ʼ é i |
imbaipýva.	 i m b a i p ý v a . |
Ita'yrakuéra	 I t a ' y r a k u é r a |
oipytyvõkuri	 o i p y t y v õ k u r i |
ichupe	 i c h u p e |
Ajépango	 A j é p a n g o |
ijetu'u	 i j e t u ' u |
hoga'ỹva	 h o g a ' ỹ v a |
rekove.	 r e k o v e . |
Oúkuri	 O ú k u r i |
hendápe	 h e n d á p e |
ojerurévo	 o j e r u r é v o |
pytyvõ,	 p y t y v õ , |
tembi'u	 t e m b i ' u |
térã	 t é r ã |
pirapire.	 p i r a p i r e . |
Ahekahína	 A h e k a h í n a |
hermanope.	 h e r m a n o p e . |
upe	 u p e |
aravópe	 a r a v ó p e |
oñe'ẽ	 o ñ e ' ẽ |
mitãmimícha.	 m i t ã m i m í c h a . |
Heta	 H e t a |
hembiapokue	 h e m b i a p o k u e |
oñembohasa	 o ñ e m b o h a s a |
taʼãngaryrýipe.	 t a ʼ ã n g a r y r ý i p e . |
Ára	 Á r a |
ára,	 á r a , |
pyharevete	 p y h a r e v e t e |
oguerahava'erã	 o g u e r a h a v a ' e r ã |
vaka	 v a k a |
kamby	 k a m b y |
távape.	 t á v a p e . |
Araka'épa	 A r a k a ' é p a |
rejevýta.	 r e j e v ý t a . |
ojehu	 o j e h u |
rire	 r i r e |
Katu	 K a t u |
atererehína.	 a t e r e r e h í n a . |
kavaju	 k a v a j u |
ovéro	 o v é r o |
ikatupyry	 i k a t u p y r y |
imbaretéva	 i m b a r e t é v a |
Ág̃akatu	 Á g ̃ a k a t u |
Maria	 M a r i a |
noñemeʼẽi	 n o ñ e m e ʼ ẽ i |
mavavépe.	 m a v a v é p e . |
Tenda	 T e n d a |
ijyvy	 i j y v y |
he'õva.	 h e ' õ v a . |
Noñembo'éi	 N o ñ e m b o ' é i |
peẽme	 p e ẽ m e |
mba'épa	 m b a ' é p a |
pejapova'erã	 p e j a p o v a ' e r ã |
ág̃a	 á g ̃ a |
oikóramo	 o i k ó r a m o |
umíva.	 u m í v a . |
Upe	 U p e |
pyhare	 p y h a r e |
ndaikatuivoíkuri	 n d a i k a t u i v o í k u r i |
oke	 o k e |
Ndépa	 N d é p a |
reikuaa	 r e i k u a a |
moõpa	 m o õ p a |
Iglesia	 I g l e s i a |
de	 d e |
la	 l a |
Encarnación.	 E n c a r n a c i ó n . |
hapicha	 h a p i c h a |
ohayhu'ỹva	 o h a y h u ' ỹ v a |
Py'ỹinte	 P y ' ỹ i n t e |
Luchi	 L u c h i |
ojojuhúmiva'erã	 o j o j u h ú m i v a ' e r ã |
oñomongeta	 o ñ o m o n g e t a |
kyre'ỹ.	 k y r e ' ỹ . |
Py'aevoi	 P y ' a e v o i |
hogayguakuéra	 h o g a y g u a k u é r a |
ogueru	 o g u e r u |
ikahõrã.	 i k a h õ r ã . |
jepiveguáicha	 j e p i v e g u á i c h a |
oñembosako'i	 o ñ e m b o s a k o ' i |
mokõive	 m o k õ i v e |
osẽ	 o s ẽ |
hag̃ua	 h a g ̃ u a |
Oñembo'e	 O ñ e m b o ' e |
upéi	 u p é i |
ohypýi	 o h y p ý i |
ykaraipyrépe.	 y k a r a i p y r é p e . |
Tanepytyvõna	 T a n e p y t y v õ n a |
jaha	 j a h a |
jaterere.	 j a t e r e r e . |
Upépe	 U p é p e |
omba'apo	 o m b a ' a p o |
Koʼág̃a	 K o ʼ á g ̃ a |
oĩháicha	 o ĩ h á i c h a |
ndikatúi	 n d i k a t ú i |
Marta	 M a r t a |
omohenda	 o m o h e n d a |
hi'upy	 h i ' u p y |
mesápe	 m e s á p e |
ohendu	 o h e n d u |
ojepopetéva.	 o j e p o p e t é v a . |
mba'asy	 m b a ' a s y |
oikesapy'árõ	 o i k e s a p y ' á r õ |
nde	 n d e |
retépe	 r e t é p e |
oñeñanduka	 o ñ e ñ a n d u k a |
ára	 á r a |
heñoi'akue	 h e ñ o i ' a k u e |
Itauguápe	 I t a u g u á p e |
Y	 Y |
tapemimíre	 t a p e m i m í r e |
osyry	 o s y r y |
Mba'etekópio.	 M b a ' e t e k ó p i o . |
Aha'ãrõ	 A h a ' ã r õ |
ne	 n e |
mbohovái.	 m b o h o v á i . |
upéva	 u p é v a |
vove	 v o v e |
yvate	 y v a t e |
gotyo	 g o t y o |
ahava'erã	 a h a v a ' e r ã |
neipamírõ	 n e i p a m í r õ |
ohendujeyjeýkuri	 o h e n d u j e y j e ý k u r i |
máva	 m á v a |
ombotáva.	 o m b o t á v a . |
Tereréniko	 T e r e r é n i k o |
angirũ	 a n g i r ũ |
ñanderayhurakate'ỹva.	 ñ a n d e r a y h u r a k a t e ' ỹ v a . |
Heseʼỹ	 H e s e ʼ ỹ |
ñande	 ñ a n d e |
ndahaʼéi	 n d a h a ʼ é i |
ary	 a r y |
iñapysẽ	 i ñ a p y s ẽ |
hembiapovusu	 h e m b i a p o v u s u |
Malvina	 M a l v i n a |
Ñorairõ.	 Ñ o r a i r õ . |
iñakãnundu	 i ñ a k ã n u n d u |
hy'ái	 h y ' á i |
ososopa	 o s o s o p a |
Aníke	 A n í k e |
ndepojopy.	 n d e p o j o p y . |
Tomboyke	 T o m b o y k e |
pokarẽ,	 p o k a r ẽ , |
tovamokõi,	 t o v a m o k õ i , |
ñembotavy	 ñ e m b o t a v y |
oparei	 o p a r e i |
Oĩ	 O ĩ |
pohãnohára	 p o h ã n o h á r a |
ndoipurúiva	 n d o i p u r ú i v a |
ñana.	 ñ a n a . |
Pya'épiko	 P y a ' é p i k o |
reju	 r e j u |
jeýta.	 j e ý t a . |
Japracticáma.	 J a p r a c t i c á m a . |
oñeñongatu.	 o ñ e ñ o n g a t u . |
Oikóva	 O i k ó v a |
oikonte'arãvoi	 o i k o n t e ' a r ã v o i |
Opavavéva	 O p a v a v é v a |
omombaʼeguasúkuri	 o m o m b a ʼ e g u a s ú k u r i |
ojejapómava.	 o j e j a p ó m a v a . |
Chemoirũke	 C h e m o i r ũ k e |
irũ	 i r ũ |
Opavave	 O p a v a v e |
jaikuaa	 j a i k u a a |
jasypápe	 j a s y p á p e |
ojehasa'asyha	 o j e h a s a ' a s y h a |
oparupiete	 o p a r u p i e t e |
Mba'épa	 M b a ' é p a |
oikova'erã	 o i k o v a ' e r ã |
chehegui	 c h e h e g u i |
oñemondasapy'árõ	 o ñ e m o n d a s a p y ' á r õ |
Ejohéi	 E j o h é i |
guampa	 g u a m p a |
iky'áva.	 i k y ' á v a . |
Omba'apo	 O m b a ' a p o |
porã	 p o r ã |
omba'apokuaágui.	 o m b a ' a p o k u a á g u i . |
Oñemoña	 O ñ e m o ñ a |
hupi'águi.	 h u p i ' á g u i . |
Oguapyjeko	 O g u a p y j e k o |
yvyráre	 y v y r á r e |
kuarahy'ãme	 k u a r a h y ' ã m e |
Oguereko	 O g u e r e k o |
po	 p o |
mitã.	 m i t ã . |
Mbovy	 M b o v y |
arýpa	 a r ý p a |
reguereko.	 r e g u e r e k o . |
Kuña	 K u ñ a |
ikyre'ỹetéva	 i k y r e ' ỹ e t é v a |
voi	 v o i |
opu'ã	 o p u ' ã |
Chekaigue,	 C h e k a i g u e , |
ra'a.	 r a ' a . |
Ñana	 Ñ a n a |
ombopupuva'erã	 o m b o p u p u v a ' e r ã |
hykuere	 h y k u e r e |
hoy'uva'erã.	 h o y ' u v a ' e r ã . |
ama	 a m a |
totyky	 t o t y k y |
mbeguemi	 m b e g u e m i |
Omboperepepe,	 O m b o p e r e p e p e , |
omosunu	 o m o s u n u |
omboparapa	 o m b o p a r a p a |
tenda.	 t e n d a . |
Sombrero	 S o m b r e r o |
ka'a.	 k a ' a . |
Péicha	 P é i c h a |
jave	 j a v e |
ropu'ãmiva'erã	 r o p u ' ã m i v a ' e r ã |
rohechávo	 r o h e c h á v o |
mba'épa.	 m b a ' é p a . |
Mymbáre	 M y m b á r e |
ñeñangareko.	 ñ e ñ a n g a r e k o . |
tapicha	 t a p i c h a |
ohayhu	 o h a y h u |
añete	 a ñ e t e |
Hilario	 H i l a r i o |
hogayguakuérape.	 h o g a y g u a k u é r a p e . |
Cheñyrõmi.	 C h e ñ y r õ m i . |
Ikatúpa	 I k a t ú p a |
ahasami	 a h a s a m i |
jekoraka'e	 j e k o r a k a ' e |
mba'e.	 m b a ' e . |
Giménez	 G i m é n e z |
katu	 k a t u |
itarovavéntema	 i t a r o v a v é n t e m a |
uperire.	 u p e r i r e . |
Mba'eichajoaitépa	 M b a ' e i c h a j o a i t é p a |
Chemandu'a	 C h e m a n d u ' a |
jey	 j e y |
ag̃uahẽva'ekue	 a g ̃ u a h ẽ v a ' e k u e |
hendápe.	 h e n d á p e . |
hi'ariete	 h i ' a r i e t e |
ndéngo	 n d é n g o |
kuimba'e	 k u i m b a ' e |
nderekomarãva	 n d e r e k o m a r ã v a |
Opóvoi	 O p ó v o i |
heʼi	 h e ʼ i |
Gonzálezpe	 G o n z á l e z p e |
“Rehendúparaʼe”.	 “ R e h e n d ú p a r a ʼ e ” . |
Che	 C h e |
vare'aitereíkuri.	 v a r e ' a i t e r e í k u r i . |
oñemongeta	 o ñ e m o n g e t a |
hendive	 h e n d i v e |
Akóinte	 A k ó i n t e |
iñorairõme	 i ñ o r a i r õ m e |
oipurúkuri	 o i p u r ú k u r i |
pyʼaguapy	 p y ʼ a g u a p y |
reko.	 r e k o . |
Ojapouka	 O j a p o u k a |
ohayhúgui	 o h a y h ú g u i |
rembiayhujárape.	 r e m b i a y h u j á r a p e . |
upépe	 u p é p e |
omohu'ãkuri	 o m o h u ' ã k u r i |
mbo'esyry	 m b o ' e s y r y |
mbohapyha	 m b o h a p y h a |
Hetave	 H e t a v e |
ouhína	 o u h í n a |
hembiaporã	 h e m b i a p o r ã |
Avañeʼẽre.	 A v a ñ e ʼ ẽ r e . |
akóinte	 a k ó i n t e |
tereiko	 t e r e i k o |
tekokatúpe	 t e k o k a t ú p e |
Oñapytĩ	 O ñ a p y t ĩ |
ikyha	 i k y h a |
tatakua	 t a t a k u a |
kótare	 k ó t a r e |
Okaru	 O k a r u |
ombojoapy	 o m b o j o a p y |
Ju'i	 J u ' i |
opurahéi	 o p u r a h é i |
jave,	 j a v e , |
okýta	 o k ý t a |
Upémarõ	 U p é m a r õ |
he'i	 h e ' i |
heta	 h e t a |
Añetehápe,	 A ñ e t e h á p e , |
iñirũmimi	 i ñ i r ũ m i m i |
oñembohorýmiva'erã	 o ñ e m b o h o r ý m i v a ' e r ã |
hese.	 h e s e . |
Heterasypaitésapy'a.	 H e t e r a s y p a i t é s a p y ' a . |
Tupã	 T u p ã |
tanehaʼãrõ	 t a n e h a ʼ ã r õ |
roʼy	 r o ʼ y |
rupi.	 r u p i . |
hi'a	 h i ' a |
omongaru	 o m o n g a r u |
opavavetépe	 o p a v a v e t é p e |
ome'ẽ	 o m e ' ẽ |
kurundu'imi	 k u r u n d u ' i m i |
Maymaite	 M a y m a i t e |
ovyʼákuri.	 o v y ʼ á k u r i . |
ipirapirehetáva	 i p i r a p i r e h e t á v a |
imboriahúva	 i m b o r i a h ú v a |
Ág̃a	 Á g ̃ a |
ndopái	 n d o p á i |
Nomohu'ãi	 N o m o h u ' ã i |
iñemoarandu.	 i ñ e m o a r a n d u . |
Ndaipóringo	 N d a i p ó r i n g o |
ndehegui	 n d e h e g u i |
herakuãporãvéva	 h e r a k u ã p o r ã v é v a |
ñemuháme.	 ñ e m u h á m e . |
Jahána	 J a h á n a |
oñondive	 o ñ o n d i v e |
reipepirũ	 r e i p e p i r ũ |
iñirũme.	 i ñ i r ũ m e . |
Haʼekuéra	 H a ʼ e k u é r a |
Villarrica	 V i l l a r r i c a |
ararecha.	 a r a r e c h a . |
Dengue	 D e n g u e |
ndejapyhýrõ	 n d e j a p y h ý r õ |
pya'emíke	 p y a ' e m í k e |
tereho	 t e r e h o |
rendápe.	 r e n d á p e . |
Moõpa	 M o õ p a |
opyta.	 o p y t a . |
Eñangarekomi	 E ñ a n g a r e k o m i |
cherehe	 c h e r e h e |
pokatu	 p o k a t u |
tuichaitévape.	 t u i c h a i t é v a p e . |
ohómiva'erá	 o h ó m i v a ' e r á |
oñemombo	 o ñ e m o m b o |
hupápe	 h u p á p e |
hasẽ	 h a s ẽ |
soro.	 s o r o . |
Chipa	 C h i p a |
manduvi	 m a n d u v i |
chipa	 c h i p a |
Eho	 E h o |
eñami	 e ñ a m i |
vaka.	 v a k a . |
Guyra	 G u y r a |
opaichagua.	 o p a i c h a g u a . |
Chénte	 C h é n t e |
ha'e	 h a ' e |
ndavy'amo'ãitaha	 n d a v y ' a m o ' ã i t a h a |
so'o'ỹre	 s o ' o ' ỹ r e |
are.	 a r e . |
mba'éiko	 m b a ' é i k o |
ajapokuaa.	 a j a p o k u a a . |
Eikove	 E i k o v e |
eheja	 e h e j a |
ambuépe	 a m b u é p e |
toikove.	 t o i k o v e . |
Emboscada	 E m b o s c a d a |
araitépe.	 a r a i t é p e . |
Jepérõ	 J e p é r õ |
mba'evéma	 m b a ' e v é m a |
ndaikatúi	 n d a i k a t ú i |
ojapovévo	 o j a p o v é v o |
Leõ	 L e õ |
ju'i	 j u ' i |
oike	 o i k e |
Eñomongetami	 E ñ o m o n g e t a m i |
remimbo'e	 r e m i m b o ' e |
ndive.	 n d i v e . |
Norohenduvéi	 N o r o h e n d u v é i |
mba'eve.	 m b a ' e v e . |
ae	 a e |
yvy	 y v y |
oñepyrũjeytaha	 o ñ e p y r ũ j e y t a h a |
opaichagua	 o p a i c h a g u a |
temitỹ	 t e m i t ỹ |
ojerurékuri	 o j e r u r é k u r i |
oñeguenohẽ	 o ñ e g u e n o h ẽ |
ita	 i t a |
ombotýva	 o m b o t ý v a |
jeikeha	 j e i k e h a |
Clari	 C l a r i |
róga.	 r ó g a . |
Hekove	 H e k o v e |
ru'ã.	 r u ' ã . |
sapy'aite.	 s a p y ' a i t e . |
ipirueterei.	 i p i r u e t e r e i . |
pirapire	 p i r a p i r e |
oñemeʼẽkuri	 o ñ e m e ʼ ẽ k u r i |
jasy	 j a s y |
ohasa	 o h a s a |
rire.	 r i r e . |
ápe	 á p e |
aime	 a i m e |
roipytyvõ	 r o i p y t y v õ |
héra	 h é r a |
ryke'y.	 r y k e ' y . |
Araka'épiko	 A r a k a ' é p i k o |
oñemoarandúta.	 o ñ e m o a r a n d ú t a . |
Ahupytypotáma	 A h u p y t y p o t á m a |
Michĩ	 M i c h ĩ |
ha'úkuri.	 h a ' ú k u r i . |
Hu'y	 H u ' y |
apýre	 a p ý r e |
omoĩ	 o m o ĩ |
guyra	 g u y r a |
raguemimi.	 r a g u e m i m i . |
oñepyrũkuri	 o ñ e p y r ũ k u r i |
iñemoarandu	 i ñ e m o a r a n d u |
puraheikuaápe.	 p u r a h e i k u a á p e . |
Yva	 Y v a |
he'ẽ.	 h e ' ẽ . |
vokóike	 v o k ó i k e |
g̃uaig̃uimi	 g ̃ u a i g ̃ u i m i |
ohechaukákuri	 o h e c h a u k á k u r i |
ta'ãnga	 t a ' ã n g a |
Roñe'ẽmbareihína	 R o ñ e ' ẽ m b a r e i h í n a |
rogayguakuéra	 r o g a y g u a k u é r a |
ejerure	 e j e r u r e |
toñemoĩ	 t o ñ e m o ĩ |
purahéi	 p u r a h é i |
porã.	 p o r ã . |
Pyhare,	 P y h a r e , |
ho'ysã,	 h o ' y s ã , |
ro'yeterei.	 r o ' y e t e r e i . |
Kuruvaíre	 K u r u v a í r e |
ñañe'ẽñaína.	 ñ a ñ e ' ẽ ñ a í n a . |
Sapy'apy'a	 S a p y ' a p y ' a |
ojejuhu	 o j e j u h u |
Pláta	 P l á t a |
Yvyguy.	 Y v y g u y . |
Ani	 A n i |
rekaguai	 r e k a g u a i |
ndejehe.	 n d e j e h e . |
upévare	 u p é v a r e |
ndaipóri	 n d a i p ó r i |
ojesareko'ỹva	 o j e s a r e k o ' ỹ v a |
Ka'arupytũ	 K a ' a r u p y t ũ |
og̃uahẽ	 o g ̃ u a h ẽ |
Ambue	 A m b u e |
hembiapokue.	 h e m b i a p o k u e . |
árape	 á r a p e |
ojehova'erã	 o j e h o v a ' e r ã |
paíno	 p a í n o |
maína	 m a í n a |
rógape	 r ó g a p e |
Ikane'õmarõ	 I k a n e ' õ m a r õ |
oheka	 o h e k a |
ogami	 o g a m i |
opytu'u	 o p y t u ' u |
hag̃ua.	 h a g ̃ u a . |
osẽkuri	 o s ẽ k u r i |
ohopa	 o h o p a |
heseve	 h e s e v e |
Brasil-pe.	 B r a s i l - p e . |
ỹramo	 ỹ r a m o |
eme'ẽkuaa	 e m e ' ẽ k u a a |
chéve	 c h é v e |
tembi'urã	 t e m b i ' u r ã |
aiko.	 a i k o . |
Pya'épeko	 P y a ' é p e k o |
oho	 o h o |
ipiári.	 i p i á r i . |
kavure.	 k a v u r e . |
Avy'aite	 A v y ' a i t e |
rohecháre.	 r o h e c h á r e . |
Ha’e	 H a ’ e |
ituicha.	 i t u i c h a . |
Sa'ivépe	 S a ' i v é p e |
jajoavy.	 j a j o a v y . |
Angirũ	 A n g i r ũ |
ñaña	 ñ a ñ a |
ha'eño	 h a ' e ñ o |
Roikévo	 R o i k é v o |
ka'aguy'ípe	 k a ' a g u y ' í p e |
ajovasa.	 a j o v a s a . |
Rejapóta	 R e j a p ó t a |
rejaposéva	 r e j a p o s é v a |
reguerekóta	 r e g u e r e k ó t a |
reipotáva	 r e i p o t á v a |
Oporandu	 O p o r a n d u |
mitã'ikúerape	 m i t ã ' i k ú e r a p e |
okaru	 o k a r u |
Osẽva	 O s ẽ v a |
haku	 h a k u |
jave.	 j a v e . |
Jepémo	 J e p é m o |
ñomongeta	 ñ o m o n g e t a |
ko'ã	 k o ' ã |
mba'ére,	 m b a ' é r e , |
noñeg̃uahẽi	 n o ñ e g ̃ u a h ẽ i |
ñe'ẽme.	 ñ e ' ẽ m e . |
Hogue	 H o g u e |
hovykangy.	 h o v y k a n g y . |
reikuaa'ỹre	 r e i k u a a ' ỹ r e |
ojehepyme'ẽta	 o j e h e p y m e ' ẽ t a |
namyengoviái	 n a m y e n g o v i á i |
pe	 p e |
tesapeha.	 t e s a p e h a . |
Upémaramo	 U p é m a r a m o |
ña	 ñ a |
omoneijeýkuri	 o m o n e i j e ý k u r i |
Mbaʼéichapa	 M b a ʼ é i c h a p a |
sy.	 s y . |
maymave	 m a y m a v e |
ohenói	 o h e n ó i |
Uruku	 U r u k u |
Ohecha	 O h e c h a |
Lovi	 L o v i |
omanoite	 o m a n o i t e |
vera.	 v e r a . |
Ha'eñoiténiko	 H a ' e ñ o i t é n i k o |
omongakuaákuri	 o m o n g a k u a á k u r i |
chupekuéra	 c h u p e k u é r a |
rejapokuaa	 r e j a p o k u a a |
péicha.	 p é i c h a . |
Ohorãngue	 O h o r ã n g u e |
Tasyópe	 T a s y ó p e |
Kapiatã	 K a p i a t ã |
ruguápe.	 r u g u á p e . |
oñesũvaʼekue.	 o ñ e s ũ v a ʼ e k u e . |
ojojuhu	 o j o j u h u |
mitã'i	 m i t ã ' i |
Peru'i.	 P e r u ' i . |
Ho'u	 H o ' u |
yvakuéra.	 y v a k u é r a . |
ijupe	 i j u p e |
ohechávo	 o h e c h á v o |
guasuete.	 g u a s u e t e . |
Kapi'ipe	 K a p i ' i p e |
jeporu	 j e p o r u |
Ipirapire	 I p i r a p i r e |
kakuaa	 k a k u a a |
omba'apo.	 o m b a ' a p o . |
aranduete	 a r a n d u e t e |
mba'ejegua	 m b a ' e j e g u a |
apohára	 a p o h á r a |
ijojaha'ỹva	 i j o j a h a ' ỹ v a |
Oipytyvõ	 O i p y t y v õ |
pytuhẽ.	 p y t u h ẽ . |
Nde	 N d e |
ra'ýpiko	 r a ' ý p i k o |
noĩporãmbáimba'e	 n o ĩ p o r ã m b á i m b a ' e |
Ohasa	 O h a s a |
Perurima	 P e r u r i m a |
apysápe	 a p y s á p e |
marandu	 m a r a n d u |
pyahu.	 p y a h u . |
Urdu	 U r d u |
ñe'ẽ	 ñ e ' ẽ |
Haimete	 H a i m e t e |
amandajépe.	 a m a n d a j é p e . |
Ohechakuaa	 O h e c h a k u a a |
rehe	 r e h e |
oñembohoryseha	 o ñ e m b o h o r y s e h a |
asaje	 a s a j e |
pukukue	 p u k u k u e |
javeve	 j a v e v e |
Karai	 K a r a i |
Octubre	 O c t u b r e |
oikundaha	 o i k u n d a h a |
Omopotĩsékuri	 O m o p o t ĩ s é k u r i |
kuehe.	 k u e h e . |
rekyhyje	 r e k y h y j e |
chugui.	 c h u g u i . |
Akeséma.	 A k e s é m a . |
Jajoecha	 J a j o e c h a |
peve.	 p e v e . |
araka'eve	 a r a k a ' e v e |
ndahamo'ãi	 n d a h a m o ' ã i |
nendive	 n e n d i v e |
Ndéve	 N d é v e |
ndorojukamo'ãi	 n d o r o j u k a m o ' ã i |
Upéikatu	 U p é i k a t u |
oñe'ẽkuri	 o ñ e ' ẽ k u r i |
mbo'ehára.	 m b o ' e h á r a . |
Emaña	 E m a ñ a |
ndejehe	 n d e j e h e |
embohysýi	 e m b o h y s ý i |
nemombaretéva	 n e m o m b a r e t é v a |
Añetehápe	 A ñ e t e h á p e |
kóva	 k ó v a |
membykuña	 m e m b y k u ñ a |
Hakate'ỹjekoraka'e	 H a k a t e ' ỹ j e k o r a k a ' e |
Chopombe.	 C h o p o m b e . |
Ojerejey	 O j e r e j e y |
karia'y.	 k a r i a ' y . |
Mavavéva	 M a v a v é v a |
noipohãnokuaái	 n o i p o h ã n o k u a á i |
ichupe.	 i c h u p e . |
Pyhare	 P y h a r e |
ñasaindy	 ñ a s a i n d y |
porãme	 p o r ã m e |
Ulo	 U l o |
oguapyhína	 o g u a p y h í n a |
itapỹi	 i t a p ỹ i |
Ndaikatumo'ãvéima	 N d a i k a t u m o ' ã v é i m a |
remyatyrõ.	 r e m y a t y r õ . |
Carmen	 C a r m e n |
oúkuri	 o ú k u r i |
hasykatuetévoi.	 h a s y k a t u e t é v o i . |
Ápe	 Á p e |
távape	 t á v a p e |
ho'ysã	 h o ' y s ã |
oky.	 o k y . |
Oréniko	 O r é n i k o |
noromomba'eguasúi	 n o r o m o m b a ' e g u a s ú i |
ñepyrũrãme.	 ñ e p y r ũ r ã m e . |
Oñembyatypaite	 O ñ e m b y a t y p a i t e |
Teroja	 T e r o j a |
tekome'ẽva	 t e k o m e ' ẽ v a |
puru.	 p u r u . |
hendiverã	 h e n d i v e r ã |
ka'ay	 k a ' a y |
he'ẽ	 h e ' ẽ |
Alfonso	 A l f o n s o |
itajýra	 i t a j ý r a |
ári	 á r i |
ova.	 o v a . |
rajymi	 r a j y m i |
hasykatuetéva	 h a s y k a t u e t é v a |
Oguerokirĩnte	 O g u e r o k i r ĩ n t e |
avati,	 a v a t i , |
mandi'o,	 m a n d i ' o , |
yva	 y v a |
ambuéva	 a m b u é v a |
Parroquial	 P a r r o q u i a l |
Yvyjaʼu.	 Y v y j a ʼ u . |
Hendy'imi	 H e n d y ' i m i |
tata	 t a t a |
ogue.	 o g u e . |
Iñe'ẽporãhaipyre	 I ñ e ' ẽ p o r ã h a i p y r e |
rekotee.	 r e k o t e e . |
vaicháku	 v a i c h á k u |
oñoha'ãva	 o ñ o h a ' ã v a |
Ogaygua	 O g a y g u a |
ikorapymíme	 i k o r a p y m í m e |
oñandu	 o ñ a n d u |
kuarahy	 k u a r a h y |
pytu	 p y t u |
Kuimba'e'i	 K u i m b a ' e ' i |
karape,	 k a r a p e , |
haguepáva,	 h a g u e p á v a , |
ojoguáva	 o j o g u á v a |
karaja'ípe	 k a r a j a ' í p e |
ndaje.	 n d a j e . |
Oĩva	 O ĩ v a |
ka'irãime.	 k a ' i r ã i m e . |
Asia	 A s i a |
ñe'ẽnguéra.	 ñ e ' ẽ n g u é r a . |
Ehasa	 E h a s a |
jakay'u.	 j a k a y ' u . |
ta'eporãmivoi	 t a ' e p o r ã m i v o i |
peẽme.	 p e ẽ m e . |
Ko	 K o |
léi	 l é i |
ojepurúta	 o j e p u r ú t a |
ñemoarandu	 ñ e m o a r a n d u |
ñemosãsorã.	 ñ e m o s ã s o r ã . |
omymbajukaitereíva.	 o m y m b a j u k a i t e r e í v a . |
oréve	 o r é v e |
pohã.	 p o h ã . |
Oréko	 O r é k o |
oreresãi	 o r e r e s ã i |
rovy'a	 r o v y ' a |
amo	 a m o |
roimehápe.	 r o i m e h á p e . |
Roñomongeta	 R o ñ o m o n g e t a |
pya'evoi	 p y a ' e v o i |
rog̃uahẽ	 r o g ̃ u a h ẽ |
Upéva	 U p é v a |
ijarýipe	 i j a r ý i p e |
g̃uarã.	 g ̃ u a r ã . |
Peteĩva	 P e t e ĩ v a |
pende	 p e n d e |
apytégui	 a p y t é g u i |
cheme'ẽta	 c h e m e ' ẽ t a |
Ndarekói	 N d a r e k ó i |
aha	 a h a |
hag̃uáicha.	 h a g ̃ u á i c h a . |
mymbakuéra	 m y m b a k u é r a |
upepeguápe,	 u p e p e g u á p e , |
ka'i,	 k a ' i , |
ambuéva.	 a m b u é v a . |
Ko'ág̃a	 K o ' á g ̃ a |
ojehecharamo	 o j e h e c h a r a m o |
oñemomorã.	 o ñ e m o m o r ã . |
mba'épiko	 m b a ' é p i k o |
ja'éta	 j a ' é t a |
ndéve.	 n d é v e . |
Iporãrasa.	 I p o r ã r a s a . |
Opa	 O p a |
rehegua.	 r e h e g u a . |
Mymbakuéra	 M y m b a k u é r a |
papo	 p a p o |
ary.	 a r y . |
Omañasapyʼami	 O m a ñ a s a p y ʼ a m i |
orerehe	 o r e r e h e |
oho.	 o h o . |
Hykuepángo	 H y k u e p á n g o |
oĩmíva	 o ĩ m í v a |
pemboy'u	 p e m b o y ' u |
pembohasa	 p e m b o h a s a |
akãrasy	 a k ã r a s y |
amomba'eguasúniko	 a m o m b a ' e g u a s ú n i k o |
ikatúre	 i k a t ú r e |
ahasa	 a h a s a |
arave	 a r a v e |
ahayhúva	 a h a y h ú v a |
ndive	 n d i v e |
Ogueraháma	 O g u e r a h á m a |
rógape.	 r ó g a p e . |
Eporohetũ	 E p o r o h e t ũ |
Vaicháku	 V a i c h á k u |
noñanduivavoi	 n o ñ a n d u i v a v o i |
kane'õ.	 k a n e ' õ . |
Ka'asapa.	 K a ' a s a p a . |
Vokóike	 V o k ó i k e |
sapy'aitépe	 s a p y ' a i t é p e |
ogueropojáima	 o g u e r o p o j á i m a |
imba'ejerure	 i m b a ' e j e r u r e |
Eñeha'ãke	 E ñ e h a ' ã k e |
akói	 a k ó i |
eiko	 e i k o |
teko	 t e k o |
potĩme	 p o t ĩ m e |
Upeichavérõ	 U p e i c h a v é r õ |
jepe	 j e p e |
ndoúi	 n d o ú i |
ha	 h a |
ndohói	 n d o h ó i |
Kalo'ípe.	 K a l o ' í p e . |
Mba'érepa	 M b a ' é r e p a |
ogueraha	 o g u e r a h a |
mba'ehe'ẽ	 m b a ' e h e ' ẽ |
ijarýipe.	 i j a r ý i p e . |
Ha	 H a |
mba'e	 m b a ' e |
jajapóta	 j a j a p ó t a |
ñande.	 ñ a n d e . |
Péichantema	 P é i c h a n t e m a |
opyta	 o p y t a |
hikuái.	 h i k u á i . |
Omombe'u	 O m o m b e ' u |
mba'éichapa	 m b a ' é i c h a p a |
heñói	 h e ñ ó i |
iñapysẽkuri	 i ñ a p y s ẽ k u r i |
ko	 k o |
aranduka.	 a r a n d u k a . |
Chekuerái.	 C h e k u e r á i . |
Yvágagui	 Y v á g a g u i |
rejúva	 r e j ú v a |
Ojeruremavoíkuri	 O j e r u r e m a v o í k u r i |
hikuái	 h i k u á i |
peteĩ	 p e t e ĩ |
Léi	 L é i |
Guasu.	 G u a s u . |
Yvyrapã	 Y v y r a p ã |
ojapo	 o j a p o |
guajayvígui.	 g u a j a y v í g u i . |
Pe	 P e |
vy'a	 v y ' a |
ndahi'aréi	 n d a h i ' a r é i |
Pukavy	 P u k a v y |
pa'ũme	 p a ' ũ m e |
japáy	 j a p á y |
ñapu'ã.	 ñ a p u ' ã . |
Pyharepyte	 P y h a r e p y t e |
riregua	 r i r e g u a |
niko.	 n i k o . |
Upeichaite	 U p e i c h a i t e |
jekorakaʼe	 j e k o r a k a ʼ e |
ojehúkuri.	 o j e h ú k u r i . |
Ag̃ave	 A g ̃ a v e |
rohóta	 r o h ó t a |
ropurahéi	 r o p u r a h é i |
chupe.	 c h u p e . |
Kuarahy	 K u a r a h y |
ojope	 o j o p e |
Chopombe	 C h o p o m b e |
ndaje	 n d a j e |
imitã	 i m i t ã |
guive	 g u i v e |
oñangarekova'ekue	 o ñ a n g a r e k o v a ' e k u e |
Ña	 Ñ a |
Antonia-re.	 A n t o n i a - r e . |
nde?	 n d e ? |
Okyvérõnteke	 O k y v é r õ n t e k e |
okyvehína.	 o k y v e h í n a . |
Mba'éichapa	 M b a ' é i c h a p a |
umi	 u m i |
jagua	 j a g u a |
saite	 s a i t e |
ho'u	 h o ' u |
ivurromíme.	 i v u r r o m í m e . |
Isy	 I s y |
ohogue'ómiva'erã	 o h o g u e ' ó m i v a ' e r ã |
hetyma	 h e t y m a |
heviro'óre	 h e v i r o ' ó r e |
typycha	 t y p y c h a |
hũ.	 h ũ . |
Amombe'uporãta	 A m o m b e ' u p o r ã t a |
ndéve	 n d é v e |
reg̃uahẽkuaa	 r e g ̃ u a h ẽ k u a a |
ore	 o r e |
rogamíme.	 r o g a m í m e . |
Oiko	 O i k o |
ka'aguýre.	 k a ' a g u ý r e . |
Omoñaniseveseve	 O m o ñ a n i s e v e s e v e |
hymba	 h y m b a |
kavajukuéra.	 k a v a j u k u é r a . |
Peteĩ	 P e t e ĩ |
guasu	 g u a s u |
ra'ymi	 r a ' y m i |
mokõi	 m o k õ i |
kakuaáva.	 k a k u a á v a . |
kuña	 k u ñ a |
arandu	 a r a n d u |
omotenonde	 o m o t e n o n d e |
omomombaretéva	 o m o m o m b a r e t é v a |
ñane	 ñ a n e |
retã	 r e t ã |
Kuimbaʼe	 K u i m b a ʼ e |
katupyry	 k a t u p y r y |
ombaʼapóva	 o m b a ʼ a p ó v a |
ikokuépe.	 i k o k u é p e . |
Araka'eve	 A r a k a ' e v e |
jeko	 j e k o |
ndojehúi	 n d o j e h ú i |
chupe	 c h u p e |
itajyramíme	 i t a j y r a m í m e |
mba'eve	 m b a ' e v e |
ivaíva.	 i v a í v a . |
Tapicha	 T a p i c h a |
hetãrayhúva	 h e t ã r a y h ú v a |
ho'a	 h o ' a |
ñuhã	 ñ u h ã |
guasúpe	 g u a s ú p e |
Avy'aitépa	 A v y ' a i t é p a |
upéicharõ	 u p é i c h a r õ |
Guarani	 G u a r a n i |
ñe'ẽténte	 ñ e ' ẽ t é n t e |
ojepuru.	 o j e p u r u . |
Anatápente	 A n a t á p e n t e |
ojekuaavéva.	 o j e k u a a v é v a . |
Mba'érepiko	 M b a ' é r e p i k o |
reñemomombyryete	 r e ñ e m o m o m b y r y e t e |
orehegui.	 o r e h e g u i . |
Umi	 U m i |
mbaʼe	 m b a ʼ e |
ohesy	 o h e s y |
tatápe.	 t a t á p e . |
Ma'erãpiko	 M a ' e r ã p i k o |
ñañemoakãrasýta	 ñ a ñ e m o a k ã r a s ý t a |
Vy'apópe	 V y ' a p ó p e |
oikókuri	 o i k ó k u r i |
oñondive.	 o ñ o n d i v e . |
opavave	 o p a v a v e |
ijaty	 i j a t y |
tupãópe	 t u p ã ó p e |
omongaraívo	 o m o n g a r a í v o |
pindo	 p i n d o |
ojejapóva	 o j e j a p ó v a |
ogapýpe	 o g a p ý p e |
Chéveramo	 C h é v e r a m o |
g̃uarã	 g ̃ u a r ã |
ahechahague	 a h e c h a h a g u e |
jaguarete	 j a g u a r e t e |
og̃uahẽvo	 o g ̃ u a h ẽ v o |
mbokaja	 m b o k a j a |
tuja	 t u j a |
renondépe.	 r e n o n d é p e . |
upéicha	 u p é i c h a |
che	 c h e |
irũnguéra.	 i r ũ n g u é r a . |
Upéicha	 U p é i c h a |
avei	 a v e i |
oisãmbyhy	 o i s ã m b y h y |
kuatiahaipyre	 k u a t i a h a i p y r e |
itavapegua.	 i t a v a p e g u a . |
Néi,	 N é i , |
aháta	 a h á t a |
nendive.	 n e n d i v e . |
oikojeýkuri	 o i k o j e ý k u r i |
pyhare.	 p y h a r e . |
Ndaikatuvéima	 N d a i k a t u v é i m a |
ojejapo	 o j e j a p o |
hese	 h e s e |
mbaʼeve.	 m b a ʼ e v e . |
Onohẽmbaitékuri	 O n o h ẽ m b a i t é k u r i |
karai	 k a r a i |
kurusu	 k u r u s u |
ojuhúva	 o j u h ú v a |
hapépe.	 h a p é p e . |
oikóva	 o i k ó v a |
ambue	 a m b u e |
táva	 t á v a |
rupi	 r u p i |
Ajetepyso	 A j e t e p y s o |
asẽ	 a s ẽ |
korapýpe.	 k o r a p ý p e . |
Mborayhu	 M b o r a y h u |
ijapyra'ỹva	 i j a p y r a ' ỹ v a |
Iñirũnguéra	 I ñ i r ũ n g u é r a |
niko	 n i k o |
ohupi	 o h u p i |
ijyva	 i j y v a |
ári.	 á r i . |
Mávapa	 M á v a p a |
mboʼehára	 m b o ʼ e h á r a |
ikatupyryvéva?	 i k a t u p y r y v é v a ? |
Mba'eichahápepiko	 M b a ' e i c h a h á p e p i k o |
oiko	 o i k o |
nderehe	 n d e r e h e |
upéva.	 u p é v a . |
Heko.	 H e k o . |
Mano	 M a n o |
Teʼõnguekuaaty	 T e ʼ õ n g u e k u a a t y |
Ayvureko	 A y v u r e k o |
rehe.	 r e h e . |
Ary	 A r y |
Pyahúpe.	 P y a h ú p e . |
Ndahaʼéi	 N d a h a ʼ é i |
imbaipýva.	 i m b a i p ý v a . |
Ita'yrakuéra	 I t a ' y r a k u é r a |
oipytyvõkuri	 o i p y t y v õ k u r i |
ichupe	 i c h u p e |
Ajépango	 A j é p a n g o |
ijetu'u	 i j e t u ' u |
hoga'ỹva	 h o g a ' ỹ v a |
rekove.	 r e k o v e . |
Oúkuri	 O ú k u r i |
hendápe	 h e n d á p e |
ojerurévo	 o j e r u r é v o |
pytyvõ,	 p y t y v õ , |
tembi'u	 t e m b i ' u |
térã	 t é r ã |
pirapire.	 p i r a p i r e . |
Ahekahína	 A h e k a h í n a |
hermanope.	 h e r m a n o p e . |
upe	 u p e |
aravópe	 a r a v ó p e |
oñe'ẽ	 o ñ e ' ẽ |
mitãmimícha.	 m i t ã m i m í c h a . |
Heta	 H e t a |
hembiapokue	 h e m b i a p o k u e |
oñembohasa	 o ñ e m b o h a s a |
taʼãngaryrýipe.	 t a ʼ ã n g a r y r ý i p e . |
Ára	 Á r a |
ára,	 á r a , |
pyharevete	 p y h a r e v e t e |
oguerahava'erã	 o g u e r a h a v a ' e r ã |
vaka	 v a k a |
kamby	 k a m b y |
távape.	 t á v a p e . |
Araka'épa	 A r a k a ' é p a |
rejevýta.	 r e j e v ý t a . |
ojehu	 o j e h u |
rire	 r i r e |
Katu	 K a t u |
atererehína.	 a t e r e r e h í n a . |
kavaju	 k a v a j u |
ovéro	 o v é r o |
ikatupyry	 i k a t u p y r y |
imbaretéva	 i m b a r e t é v a |
Ág̃akatu	 Á g ̃ a k a t u |
Maria	 M a r i a |
noñemeʼẽi	 n o ñ e m e ʼ ẽ i |
mavavépe.	 m a v a v é p e . |
Tenda	 T e n d a |
ijyvy	 i j y v y |
he'õva.	 h e ' õ v a . |
Noñembo'éi	 N o ñ e m b o ' é i |
peẽme	 p e ẽ m e |
mba'épa	 m b a ' é p a |
pejapova'erã	 p e j a p o v a ' e r ã |
ág̃a	 á g ̃ a |
oikóramo	 o i k ó r a m o |
umíva.	 u m í v a . |
Upe	 U p e |
pyhare	 p y h a r e |
ndaikatuivoíkuri	 n d a i k a t u i v o í k u r i |
oke	 o k e |
Ndépa	 N d é p a |
reikuaa	 r e i k u a a |
moõpa	 m o õ p a |
Iglesia	 I g l e s i a |
de	 d e |
la	 l a |
Encarnación.	 E n c a r n a c i ó n . |
hapicha	 h a p i c h a |
ohayhu'ỹva	 o h a y h u ' ỹ v a |
Py'ỹinte	 P y ' ỹ i n t e |
Luchi	 L u c h i |
ojojuhúmiva'erã	 o j o j u h ú m i v a ' e r ã |
oñomongeta	 o ñ o m o n g e t a |
kyre'ỹ.	 k y r e ' ỹ . |
Py'aevoi	 P y ' a e v o i |
hogayguakuéra	 h o g a y g u a k u é r a |
ogueru	 o g u e r u |
ikahõrã.	 i k a h õ r ã . |
jepiveguáicha	 j e p i v e g u á i c h a |
oñembosako'i	 o ñ e m b o s a k o ' i |
mokõive	 m o k õ i v e |
osẽ	 o s ẽ |
hag̃ua	 h a g ̃ u a |
Oñembo'e	 O ñ e m b o ' e |
upéi	 u p é i |
ohypýi	 o h y p ý i |
ykaraipyrépe.	 y k a r a i p y r é p e . |
Tanepytyvõna	 T a n e p y t y v õ n a |
jaha	 j a h a |
jaterere.	 j a t e r e r e . |
Upépe	 U p é p e |
omba'apo	 o m b a ' a p o |
Koʼág̃a	 K o ʼ á g ̃ a |
oĩháicha	 o ĩ h á i c h a |
ndikatúi	 n d i k a t ú i |
Marta	 M a r t a |
omohenda	 o m o h e n d a |
hi'upy	 h i ' u p y |
mesápe	 m e s á p e |
ohendu	 o h e n d u |
ojepopetéva.	 o j e p o p e t é v a . |
mba'asy	 m b a ' a s y |
oikesapy'árõ	 o i k e s a p y ' á r õ |
nde	 n d e |
retépe	 r e t é p e |
oñeñanduka	 o ñ e ñ a n d u k a |
ára	 á r a |
heñoi'akue	 h e ñ o i ' a k u e |
Itauguápe	 I t a u g u á p e |
Y	 Y |
tapemimíre	 t a p e m i m í r e |
osyry	 o s y r y |
Mba'etekópio.	 M b a ' e t e k ó p i o . |
Aha'ãrõ	 A h a ' ã r õ |
ne	 n e |
mbohovái.	 m b o h o v á i . |
upéva	 u p é v a |
vove	 v o v e |
yvate	 y v a t e |
gotyo	 g o t y o |
ahava'erã	 a h a v a ' e r ã |
neipamírõ	 n e i p a m í r õ |
ohendujeyjeýkuri	 o h e n d u j e y j e ý k u r i |
máva	 m á v a |
ombotáva.	 o m b o t á v a . |
Tereréniko	 T e r e r é n i k o |
angirũ	 a n g i r ũ |
ñanderayhurakate'ỹva.	 ñ a n d e r a y h u r a k a t e ' ỹ v a . |
Heseʼỹ	 H e s e ʼ ỹ |
ñande	 ñ a n d e |
ndahaʼéi	 n d a h a ʼ é i |
ary	 a r y |
iñapysẽ	 i ñ a p y s ẽ |
hembiapovusu	 h e m b i a p o v u s u |
Malvina	 M a l v i n a |
Ñorairõ.	 Ñ o r a i r õ . |
iñakãnundu	 i ñ a k ã n u n d u |
hy'ái	 h y ' á i |
ososopa	 o s o s o p a |
Aníke	 A n í k e |
ndepojopy.	 n d e p o j o p y . |
Tomboyke	 T o m b o y k e |
pokarẽ,	 p o k a r ẽ , |
tovamokõi,	 t o v a m o k õ i , |
ñembotavy	 ñ e m b o t a v y |
oparei	 o p a r e i |
Oĩ	 O ĩ |
pohãnohára	 p o h ã n o h á r a |
ndoipurúiva	 n d o i p u r ú i v a |
ñana.	 ñ a n a . |
Pya'épiko	 P y a ' é p i k o |
reju	 r e j u |
jeýta.	 j e ý t a . |
Japracticáma.	 J a p r a c t i c á m a . |
oñeñongatu.	 o ñ e ñ o n g a t u . |
Oikóva	 O i k ó v a |
oikonte'arãvoi	 o i k o n t e ' a r ã v o i |
Opavavéva	 O p a v a v é v a |
omombaʼeguasúkuri	 o m o m b a ʼ e g u a s ú k u r i |
ojejapómava.	 o j e j a p ó m a v a . |
Chemoirũke	 C h e m o i r ũ k e |
irũ	 i r ũ |
Opavave	 O p a v a v e |
jaikuaa	 j a i k u a a |
jasypápe	 j a s y p á p e |
ojehasa'asyha	 o j e h a s a ' a s y h a |
oparupiete	 o p a r u p i e t e |
Mba'épa	 M b a ' é p a |
oikova'erã	 o i k o v a ' e r ã |
chehegui	 c h e h e g u i |
oñemondasapy'árõ	 o ñ e m o n d a s a p y ' á r õ |
Ejohéi	 E j o h é i |
guampa	 g u a m p a |
iky'áva.	 i k y ' á v a . |
Omba'apo	 O m b a ' a p o |
porã	 p o r ã |
omba'apokuaágui.	 o m b a ' a p o k u a á g u i . |
Oñemoña	 O ñ e m o ñ a |
hupi'águi.	 h u p i ' á g u i . |
Oguapyjeko	 O g u a p y j e k o |
yvyráre	 y v y r á r e |
kuarahy'ãme	 k u a r a h y ' ã m e |
Oguereko	 O g u e r e k o |
po	 p o |
mitã.	 m i t ã . |
Mbovy	 M b o v y |
arýpa	 a r ý p a |
reguereko.	 r e g u e r e k o . |
Kuña	 K u ñ a |
ikyre'ỹetéva	 i k y r e ' ỹ e t é v a |
voi	 v o i |
opu'ã	 o p u ' ã |
Chekaigue,	 C h e k a i g u e , |
ra'a.	 r a ' a . |
Ñana	 Ñ a n a |
ombopupuva'erã	 o m b o p u p u v a ' e r ã |
hykuere	 h y k u e r e |
hoy'uva'erã.	 h o y ' u v a ' e r ã . |
ama	 a m a |
totyky	 t o t y k y |
mbeguemi	 m b e g u e m i |
Omboperepepe,	 O m b o p e r e p e p e , |
omosunu	 o m o s u n u |
omboparapa	 o m b o p a r a p a |
tenda.	 t e n d a . |
Sombrero	 S o m b r e r o |
ka'a.	 k a ' a . |
Péicha	 P é i c h a |
jave	 j a v e |
ropu'ãmiva'erã	 r o p u ' ã m i v a ' e r ã |
rohechávo	 r o h e c h á v o |
mba'épa.	 m b a ' é p a . |
Mymbáre	 M y m b á r e |
ñeñangareko.	 ñ e ñ a n g a r e k o . |
tapicha	 t a p i c h a |
ohayhu	 o h a y h u |
añete	 a ñ e t e |
Hilario	 H i l a r i o |
hogayguakuérape.	 h o g a y g u a k u é r a p e . |
Cheñyrõmi.	 C h e ñ y r õ m i . |
Ikatúpa	 I k a t ú p a |
ahasami	 a h a s a m i |
jekoraka'e	 j e k o r a k a ' e |
mba'e.	 m b a ' e . |
Giménez	 G i m é n e z |
katu	 k a t u |
itarovavéntema	 i t a r o v a v é n t e m a |
uperire.	 u p e r i r e . |
Mba'eichajoaitépa	 M b a ' e i c h a j o a i t é p a |
Chemandu'a	 C h e m a n d u ' a |
jey	 j e y |
ag̃uahẽva'ekue	 a g ̃ u a h ẽ v a ' e k u e |
hendápe.	 h e n d á p e . |
hi'ariete	 h i ' a r i e t e |
ndéngo	 n d é n g o |
kuimba'e	 k u i m b a ' e |
nderekomarãva	 n d e r e k o m a r ã v a |
Opóvoi	 O p ó v o i |
heʼi	 h e ʼ i |
Gonzálezpe	 G o n z á l e z p e |
“Rehendúparaʼe”.	 “ R e h e n d ú p a r a ʼ e ” . |
Che	 C h e |
vare'aitereíkuri.	 v a r e ' a i t e r e í k u r i . |
oñemongeta	 o ñ e m o n g e t a |
hendive	 h e n d i v e |
Akóinte	 A k ó i n t e |
iñorairõme	 i ñ o r a i r õ m e |
oipurúkuri	 o i p u r ú k u r i |
pyʼaguapy	 p y ʼ a g u a p y |
reko.	 r e k o . |
Ojapouka	 O j a p o u k a |
ohayhúgui	 o h a y h ú g u i |
rembiayhujárape.	 r e m b i a y h u j á r a p e . |
upépe	 u p é p e |
omohu'ãkuri	 o m o h u ' ã k u r i |
mbo'esyry	 m b o ' e s y r y |
mbohapyha	 m b o h a p y h a |
Hetave	 H e t a v e |
ouhína	 o u h í n a |
hembiaporã	 h e m b i a p o r ã |
Avañeʼẽre.	 A v a ñ e ʼ ẽ r e . |
akóinte	 a k ó i n t e |
tereiko	 t e r e i k o |
tekokatúpe	 t e k o k a t ú p e |
Oñapytĩ	 O ñ a p y t ĩ |
ikyha	 i k y h a |
tatakua	 t a t a k u a |
kótare	 k ó t a r e |
Okaru	 O k a r u |
ombojoapy	 o m b o j o a p y |
Ju'i	 J u ' i |
opurahéi	 o p u r a h é i |
jave,	 j a v e , |
okýta	 o k ý t a |
Upémarõ	 U p é m a r õ |
he'i	 h e ' i |
heta	 h e t a |
Añetehápe,	 A ñ e t e h á p e , |
iñirũmimi	 i ñ i r ũ m i m i |
oñembohorýmiva'erã	 o ñ e m b o h o r ý m i v a ' e r ã |
hese.	 h e s e . |
Heterasypaitésapy'a.	 H e t e r a s y p a i t é s a p y ' a . |
Tupã	 T u p ã |
tanehaʼãrõ	 t a n e h a ʼ ã r õ |
roʼy	 r o ʼ y |
rupi.	 r u p i . |
hi'a	 h i ' a |
omongaru	 o m o n g a r u |
opavavetépe	 o p a v a v e t é p e |
ome'ẽ	 o m e ' ẽ |
kurundu'imi	 k u r u n d u ' i m i |
Maymaite	 M a y m a i t e |
ovyʼákuri.	 o v y ʼ á k u r i . |
ipirapirehetáva	 i p i r a p i r e h e t á v a |
imboriahúva	 i m b o r i a h ú v a |
Ág̃a	 Á g ̃ a |
ndopái	 n d o p á i |
Nomohu'ãi	 N o m o h u ' ã i |
iñemoarandu.	 i ñ e m o a r a n d u . |
Ndaipóringo	 N d a i p ó r i n g o |
ndehegui	 n d e h e g u i |
herakuãporãvéva	 h e r a k u ã p o r ã v é v a |
ñemuháme.	 ñ e m u h á m e . |
Jahána	 J a h á n a |
oñondive	 o ñ o n d i v e |
reipepirũ	 r e i p e p i r ũ |
iñirũme.	 i ñ i r ũ m e . |
Haʼekuéra	 H a ʼ e k u é r a |
Villarrica	 V i l l a r r i c a |
ararecha.	 a r a r e c h a . |
Dengue	 D e n g u e |
ndejapyhýrõ	 n d e j a p y h ý r õ |
pya'emíke	 p y a ' e m í k e |
tereho	 t e r e h o |
rendápe.	 r e n d á p e . |
Moõpa	 M o õ p a |
opyta.	 o p y t a . |
Eñangarekomi	 E ñ a n g a r e k o m i |
cherehe	 c h e r e h e |
pokatu	 p o k a t u |
tuichaitévape.	 t u i c h a i t é v a p e . |
ohómiva'erá	 o h ó m i v a ' e r á |
oñemombo	 o ñ e m o m b o |
hupápe	 h u p á p e |
hasẽ	 h a s ẽ |
soro.	 s o r o . |
Chipa	 C h i p a |
manduvi	 m a n d u v i |
chipa	 c h i p a |
Eho	 E h o |
eñami	 e ñ a m i |
vaka.	 v a k a . |
Guyra	 G u y r a |
opaichagua.	 o p a i c h a g u a . |
Chénte	 C h é n t e |
ha'e	 h a ' e |
ndavy'amo'ãitaha	 n d a v y ' a m o ' ã i t a h a |
so'o'ỹre	 s o ' o ' ỹ r e |
are.	 a r e . |
mba'éiko	 m b a ' é i k o |
ajapokuaa.	 a j a p o k u a a . |
Eikove	 E i k o v e |
eheja	 e h e j a |
ambuépe	 a m b u é p e |
toikove.	 t o i k o v e . |
Emboscada	 E m b o s c a d a |
araitépe.	 a r a i t é p e . |
Jepérõ	 J e p é r õ |
mba'evéma	 m b a ' e v é m a |
ndaikatúi	 n d a i k a t ú i |
ojapovévo	 o j a p o v é v o |
Leõ	 L e õ |
ju'i	 j u ' i |
oike	 o i k e |
Eñomongetami	 E ñ o m o n g e t a m i |
remimbo'e	 r e m i m b o ' e |
ndive.	 n d i v e . |
Norohenduvéi	 N o r o h e n d u v é i |
mba'eve.	 m b a ' e v e . |
ae	 a e |
yvy	 y v y |
oñepyrũjeytaha	 o ñ e p y r ũ j e y t a h a |
opaichagua	 o p a i c h a g u a |
temitỹ	 t e m i t ỹ |
ojerurékuri	 o j e r u r é k u r i |
oñeguenohẽ	 o ñ e g u e n o h ẽ |
ita	 i t a |
ombotýva	 o m b o t ý v a |
jeikeha	 j e i k e h a |
Clari	 C l a r i |
róga.	 r ó g a . |
Hekove	 H e k o v e |
ru'ã.	 r u ' ã . |
sapy'aite.	 s a p y ' a i t e . |
ipirueterei.	 i p i r u e t e r e i . |
pirapire	 p i r a p i r e |
oñemeʼẽkuri	 o ñ e m e ʼ ẽ k u r i |
jasy	 j a s y |
ohasa	 o h a s a |
rire.	 r i r e . |
ápe	 á p e |
aime	 a i m e |
roipytyvõ	 r o i p y t y v õ |
héra	 h é r a |
ryke'y.	 r y k e ' y . |
Araka'épiko	 A r a k a ' é p i k o |
oñemoarandúta.	 o ñ e m o a r a n d ú t a . |
Ahupytypotáma	 A h u p y t y p o t á m a |
Michĩ	 M i c h ĩ |
ha'úkuri.	 h a ' ú k u r i . |
Hu'y	 H u ' y |
apýre	 a p ý r e |
omoĩ	 o m o ĩ |
guyra	 g u y r a |
raguemimi.	 r a g u e m i m i . |
oñepyrũkuri	 o ñ e p y r ũ k u r i |
iñemoarandu	 i ñ e m o a r a n d u |
puraheikuaápe.	 p u r a h e i k u a á p e . |
Yva	 Y v a |
he'ẽ.	 h e ' ẽ . |
vokóike	 v o k ó i k e |
g̃uaig̃uimi	 g ̃ u a i g ̃ u i m i |
ohechaukákuri	 o h e c h a u k á k u r i |
ta'ãnga	 t a ' ã n g a |
Roñe'ẽmbareihína	 R o ñ e ' ẽ m b a r e i h í n a |
rogayguakuéra	 r o g a y g u a k u é r a |
ejerure	 e j e r u r e |
toñemoĩ	 t o ñ e m o ĩ |
purahéi	 p u r a h é i |
porã.	 p o r ã . |
Pyhare,	 P y h a r e , |
ho'ysã,	 h o ' y s ã , |
ro'yeterei.	 r o ' y e t e r e i . |
Kuruvaíre	 K u r u v a í r e |
ñañe'ẽñaína.	 ñ a ñ e ' ẽ ñ a í n a . |
Sapy'apy'a	 S a p y ' a p y ' a |
ojejuhu	 o j e j u h u |
Pláta	 P l á t a |
Yvyguy.	 Y v y g u y . |
Ani	 A n i |
rekaguai	 r e k a g u a i |
ndejehe.	 n d e j e h e . |
upévare	 u p é v a r e |
ndaipóri	 n d a i p ó r i |
ojesareko'ỹva	 o j e s a r e k o ' ỹ v a |
Ka'arupytũ	 K a ' a r u p y t ũ |
og̃uahẽ	 o g ̃ u a h ẽ |
Ambue	 A m b u e |
hembiapokue.	 h e m b i a p o k u e . |
árape	 á r a p e |
ojehova'erã	 o j e h o v a ' e r ã |
paíno	 p a í n o |
maína	 m a í n a |
rógape	 r ó g a p e |
Ikane'õmarõ	 I k a n e ' õ m a r õ |
oheka	 o h e k a |
ogami	 o g a m i |
opytu'u	 o p y t u ' u |
hag̃ua.	 h a g ̃ u a . |
osẽkuri	 o s ẽ k u r i |
ohopa	 o h o p a |
heseve	 h e s e v e |
Brasil-pe.	 B r a s i l - p e . |
ỹramo	 ỹ r a m o |
eme'ẽkuaa	 e m e ' ẽ k u a a |
chéve	 c h é v e |
tembi'urã	 t e m b i ' u r ã |
aiko.	 a i k o . |
Pya'épeko	 P y a ' é p e k o |
oho	 o h o |
ipiári.	 i p i á r i . |
kavure.	 k a v u r e . |
Avy'aite	 A v y ' a i t e |
rohecháre.	 r o h e c h á r e . |
Ha’e	 H a ’ e |
ituicha.	 i t u i c h a . |
Sa'ivépe	 S a ' i v é p e |
jajoavy.	 j a j o a v y . |
Angirũ	 A n g i r ũ |
ñaña	 ñ a ñ a |
ha'eño	 h a ' e ñ o |
Roikévo	 R o i k é v o |
ka'aguy'ípe	 k a ' a g u y ' í p e |
ajovasa.	 a j o v a s a . |
Rejapóta	 R e j a p ó t a |
rejaposéva	 r e j a p o s é v a |
reguerekóta	 r e g u e r e k ó t a |
reipotáva	 r e i p o t á v a |
Oporandu	 O p o r a n d u |
mitã'ikúerape	 m i t ã ' i k ú e r a p e |
okaru	 o k a r u |
Osẽva	 O s ẽ v a |
haku	 h a k u |
jave.	 j a v e . |
Jepémo	 J e p é m o |
ñomongeta	 ñ o m o n g e t a |
ko'ã	 k o ' ã |
mba'ére,	 m b a ' é r e , |
noñeg̃uahẽi	 n o ñ e g ̃ u a h ẽ i |
ñe'ẽme.	 ñ e ' ẽ m e . |
Hogue	 H o g u e |
hovykangy.	 h o v y k a n g y . |
reikuaa'ỹre	 r e i k u a a ' ỹ r e |
ojehepyme'ẽta	 o j e h e p y m e ' ẽ t a |
namyengoviái	 n a m y e n g o v i á i |
pe	 p e |
tesapeha.	 t e s a p e h a . |
Upémaramo	 U p é m a r a m o |
ña	 ñ a |
omoneijeýkuri	 o m o n e i j e ý k u r i |
Mbaʼéichapa	 M b a ʼ é i c h a p a |
sy.	 s y . |
maymave	 m a y m a v e |
ohenói	 o h e n ó i |
Uruku	 U r u k u |
Ohecha	 O h e c h a |
Lovi	 L o v i |
omanoite	 o m a n o i t e |
vera.	 v e r a . |
Ha'eñoiténiko	 H a ' e ñ o i t é n i k o |
omongakuaákuri	 o m o n g a k u a á k u r i |
chupekuéra	 c h u p e k u é r a |
rejapokuaa	 r e j a p o k u a a |
péicha.	 p é i c h a . |
Ohorãngue	 O h o r ã n g u e |
Tasyópe	 T a s y ó p e |
Kapiatã	 K a p i a t ã |
ruguápe.	 r u g u á p e . |
oñesũvaʼekue.	 o ñ e s ũ v a ʼ e k u e . |
ojojuhu	 o j o j u h u |
mitã'i	 m i t ã ' i |
Peru'i.	 P e r u ' i . |
Ho'u	 H o ' u |
yvakuéra.	 y v a k u é r a . |
ijupe	 i j u p e |
ohechávo	 o h e c h á v o |
guasuete.	 g u a s u e t e . |
Kapi'ipe	 K a p i ' i p e |
jeporu	 j e p o r u |
Ipirapire	 I p i r a p i r e |
kakuaa	 k a k u a a |
omba'apo.	 o m b a ' a p o . |
aranduete	 a r a n d u e t e |
mba'ejegua	 m b a ' e j e g u a |
apohára	 a p o h á r a |
ijojaha'ỹva	 i j o j a h a ' ỹ v a |
Oipytyvõ	 O i p y t y v õ |
pytuhẽ.	 p y t u h ẽ . |
Nde	 N d e |
ra'ýpiko	 r a ' ý p i k o |
noĩporãmbáimba'e	 n o ĩ p o r ã m b á i m b a ' e |
Ohasa	 O h a s a |
Perurima	 P e r u r i m a |
apysápe	 a p y s á p e |
marandu	 m a r a n d u |
pyahu.	 p y a h u . |
Urdu	 U r d u |
ñe'ẽ	 ñ e ' ẽ |
Haimete	 H a i m e t e |
amandajépe.	 a m a n d a j é p e . |
Ohechakuaa	 O h e c h a k u a a |
rehe	 r e h e |
oñembohoryseha	 o ñ e m b o h o r y s e h a |
asaje	 a s a j e |
pukukue	 p u k u k u e |
javeve	 j a v e v e |
Karai	 K a r a i |
Octubre	 O c t u b r e |
oikundaha	 o i k u n d a h a |
Omopotĩsékuri	 O m o p o t ĩ s é k u r i |
kuehe.	 k u e h e . |
rekyhyje	 r e k y h y j e |
chugui.	 c h u g u i . |
Akeséma.	 A k e s é m a . |
Jajoecha	 J a j o e c h a |
peve.	 p e v e . |
araka'eve	 a r a k a ' e v e |
ndahamo'ãi	 n d a h a m o ' ã i |
nendive	 n e n d i v e |
Ndéve	 N d é v e |
ndorojukamo'ãi	 n d o r o j u k a m o ' ã i |
Upéikatu	 U p é i k a t u |
oñe'ẽkuri	 o ñ e ' ẽ k u r i |
mbo'ehára.	 m b o ' e h á r a . |
Emaña	 E m a ñ a |
ndejehe	 n d e j e h e |
embohysýi	 e m b o h y s ý i |
nemombaretéva	 n e m o m b a r e t é v a |
Añetehápe	 A ñ e t e h á p e |
kóva	 k ó v a |
membykuña	 m e m b y k u ñ a |
Hakate'ỹjekoraka'e	 H a k a t e ' ỹ j e k o r a k a ' e |
Chopombe.	 C h o p o m b e . |
Ojerejey	 O j e r e j e y |
karia'y.	 k a r i a ' y . |
Mavavéva	 M a v a v é v a |
noipohãnokuaái	 n o i p o h ã n o k u a á i |
ichupe.	 i c h u p e . |
Pyhare	 P y h a r e |
ñasaindy	 ñ a s a i n d y |
porãme	 p o r ã m e |
Ulo	 U l o |
oguapyhína	 o g u a p y h í n a |
itapỹi	 i t a p ỹ i |
Ndaikatumo'ãvéima	 N d a i k a t u m o ' ã v é i m a |
remyatyrõ.	 r e m y a t y r õ . |
Carmen	 C a r m e n |
oúkuri	 o ú k u r i |
hasykatuetévoi.	 h a s y k a t u e t é v o i . |
Ápe	 Á p e |
távape	 t á v a p e |
ho'ysã	 h o ' y s ã |
oky.	 o k y . |
Oréniko	 O r é n i k o |
noromomba'eguasúi	 n o r o m o m b a ' e g u a s ú i |
ñepyrũrãme.	 ñ e p y r ũ r ã m e . |
Oñembyatypaite	 O ñ e m b y a t y p a i t e |
Teroja	 T e r o j a |
tekome'ẽva	 t e k o m e ' ẽ v a |
puru.	 p u r u . |
hendiverã	 h e n d i v e r ã |
ka'ay	 k a ' a y |
he'ẽ	 h e ' ẽ |
Alfonso	 A l f o n s o |
itajýra	 i t a j ý r a |
ári	 á r i |
ova.	 o v a . |
rajymi	 r a j y m i |
hasykatuetéva	 h a s y k a t u e t é v a |
Oguerokirĩnte	 O g u e r o k i r ĩ n t e |
avati,	 a v a t i , |
mandi'o,	 m a n d i ' o , |
yva	 y v a |
ambuéva	 a m b u é v a |
Parroquial	 P a r r o q u i a l |
Yvyjaʼu.	 Y v y j a ʼ u . |
Hendy'imi	 H e n d y ' i m i |
tata	 t a t a |
ogue.	 o g u e . |
Iñe'ẽporãhaipyre	 I ñ e ' ẽ p o r ã h a i p y r e |
rekotee.	 r e k o t e e . |
vaicháku	 v a i c h á k u |
oñoha'ãva	 o ñ o h a ' ã v a |
Ogaygua	 O g a y g u a |
ikorapymíme	 i k o r a p y m í m e |
oñandu	 o ñ a n d u |
kuarahy	 k u a r a h y |
pytu	 p y t u |
Kuimba'e'i	 K u i m b a ' e ' i |
karape,	 k a r a p e , |
haguepáva,	 h a g u e p á v a , |
ojoguáva	 o j o g u á v a |
karaja'ípe	 k a r a j a ' í p e |
ndaje.	 n d a j e . |
Oĩva	 O ĩ v a |
ka'irãime.	 k a ' i r ã i m e . |
Asia	 A s i a |
ñe'ẽnguéra.	 ñ e ' ẽ n g u é r a . |
Ehasa	 E h a s a |
jakay'u.	 j a k a y ' u . |
ta'eporãmivoi	 t a ' e p o r ã m i v o i |
peẽme.	 p e ẽ m e . |
Ko	 K o |
léi	 l é i |
ojepurúta	 o j e p u r ú t a |
ñemoarandu	 ñ e m o a r a n d u |
ñemosãsorã.	 ñ e m o s ã s o r ã . |
omymbajukaitereíva.	 o m y m b a j u k a i t e r e í v a . |
oréve	 o r é v e |
pohã.	 p o h ã . |
Oréko	 O r é k o |
oreresãi	 o r e r e s ã i |
rovy'a	 r o v y ' a |
amo	 a m o |
roimehápe.	 r o i m e h á p e . |
Roñomongeta	 R o ñ o m o n g e t a |
pya'evoi	 p y a ' e v o i |
rog̃uahẽ	 r o g ̃ u a h ẽ |
Upéva	 U p é v a |
ijarýipe	 i j a r ý i p e |
g̃uarã.	 g ̃ u a r ã . |
Peteĩva	 P e t e ĩ v a |
pende	 p e n d e |
apytégui	 a p y t é g u i |
cheme'ẽta	 c h e m e ' ẽ t a |
Ndarekói	 N d a r e k ó i |
aha	 a h a |
hag̃uáicha.	 h a g ̃ u á i c h a . |
mymbakuéra	 m y m b a k u é r a |
upepeguápe,	 u p e p e g u á p e , |
ka'i,	 k a ' i , |
ambuéva.	 a m b u é v a . |
Ko'ág̃a	 K o ' á g ̃ a |
ojehecharamo	 o j e h e c h a r a m o |
oñemomorã.	 o ñ e m o m o r ã . |
mba'épiko	 m b a ' é p i k o |
ja'éta	 j a ' é t a |
ndéve.	 n d é v e . |
Iporãrasa.	 I p o r ã r a s a . |
Opa	 O p a |
rehegua.	 r e h e g u a . |
Mymbakuéra	 M y m b a k u é r a |
papo	 p a p o |
ary.	 a r y . |
Omañasapyʼami	 O m a ñ a s a p y ʼ a m i |
orerehe	 o r e r e h e |
oho.	 o h o . |
Hykuepángo	 H y k u e p á n g o |
oĩmíva	 o ĩ m í v a |
pemboy'u	 p e m b o y ' u |
pembohasa	 p e m b o h a s a |
akãrasy	 a k ã r a s y |
amomba'eguasúniko	 a m o m b a ' e g u a s ú n i k o |
ikatúre	 i k a t ú r e |
ahasa	 a h a s a |
arave	 a r a v e |
ahayhúva	 a h a y h ú v a |
ndive	 n d i v e |
Ogueraháma	 O g u e r a h á m a |
rógape.	 r ó g a p e . |
Eporohetũ	 E p o r o h e t ũ |
Vaicháku	 V a i c h á k u |
noñanduivavoi	 n o ñ a n d u i v a v o i |
kane'õ.	 k a n e ' õ . |
Ka'asapa.	 K a ' a s a p a . |
Vokóike	 V o k ó i k e |
sapy'aitépe	 s a p y ' a i t é p e |
ogueropojáima	 o g u e r o p o j á i m a |
imba'ejerure	 i m b a ' e j e r u r e |
eñeha'ãke	 e ñ e h a ' ã k e |
akói	 a k ó i |
eiko	 e i k o |
teko	 t e k o |
potĩme	 p o t ĩ m e |
upeichavérõ	 u p e i c h a v é r õ |
jepe	 j e p e |
ndoúi	 n d o ú i |
ha	 h a |
ndohói	 n d o h ó i |
Kalo'ípe	 K a l o ' í p e |
mba'érepa	 m b a ' é r e p a |
ogueraha	 o g u e r a h a |
mba'ehe'ẽ	 m b a ' e h e ' ẽ |
ijarýipe	 i j a r ý i p e |
mba'e	 m b a ' e |
jajapóta	 j a j a p ó t a |
ñande	 ñ a n d e |
péichantema	 p é i c h a n t e m a |
opyta	 o p y t a |
hikuái	 h i k u á i |
omombe'u	 o m o m b e ' u |
mba'éichapa	 m b a ' é i c h a p a |
heñói	 h e ñ ó i |
iñapysẽkuri	 i ñ a p y s ẽ k u r i |
ko	 k o |
aranduka	 a r a n d u k a |
chekuerái	 c h e k u e r á i |
yvágagui	 y v á g a g u i |
rejúva	 r e j ú v a |
ojeruremavoíkuri	 o j e r u r e m a v o í k u r i |
peteĩ	 p e t e ĩ |
Léi	 L é i |
Guasu	 G u a s u |
yvyrapã	 y v y r a p ã |
ojapo	 o j a p o |
guajayvígui	 g u a j a y v í g u i |
pe	 p e |
vy'a	 v y ' a |
ndahi'aréi	 n d a h i ' a r é i |
pukavy	 p u k a v y |
pa'ũme	 p a ' ũ m e |
japáy	 j a p á y |
ñapu'ã	 ñ a p u ' ã |
pyharepyte	 p y h a r e p y t e |
riregua	 r i r e g u a |
niko	 n i k o |
upeichaite	 u p e i c h a i t e |
jekorakaʼe	 j e k o r a k a ʼ e |
ojehúkuri	 o j e h ú k u r i |
ag̃ave	 a g ̃ a v e |
rohóta	 r o h ó t a |
ropurahéi	 r o p u r a h é i |
chupe	 c h u p e |
kuarahy	 k u a r a h y |
ojope	 o j o p e |
chopombe	 c h o p o m b e |
ndaje	 n d a j e |
imitã	 i m i t ã |
guive	 g u i v e |
oñangarekova'ekue	 o ñ a n g a r e k o v a ' e k u e |
Ña	 Ñ a |
Antonia-re	 A n t o n i a - r e |
nde?	 n d e ? |
okyvérõnteke	 o k y v é r õ n t e k e |
okyvehína	 o k y v e h í n a |
umi	 u m i |
jagua	 j a g u a |
saite	 s a i t e |
ho'u	 h o ' u |
ivurromíme	 i v u r r o m í m e |
isy	 i s y |
ohogue'ómiva'erã	 o h o g u e ' ó m i v a ' e r ã |
hetyma	 h e t y m a |
heviro'óre	 h e v i r o ' ó r e |
typycha	 t y p y c h a |
hũ	 h ũ |
amombe'uporãta	 a m o m b e ' u p o r ã t a |
ndéve	 n d é v e |
reg̃uahẽkuaa	 r e g ̃ u a h ẽ k u a a |
ore	 o r e |
rogamíme	 r o g a m í m e |
oiko	 o i k o |
ka'aguýre	 k a ' a g u ý r e |
omoñaniseveseve	 o m o ñ a n i s e v e s e v e |
hymba	 h y m b a |
kavajukuéra	 k a v a j u k u é r a |
guasu	 g u a s u |
ra'ymi	 r a ' y m i |
mokõi	 m o k õ i |
kakuaáva	 k a k u a á v a |
kuña	 k u ñ a |
arandu	 a r a n d u |
omotenonde	 o m o t e n o n d e |
omomombaretéva	 o m o m o m b a r e t é v a |
ñane	 ñ a n e |
retã	 r e t ã |
kuimbaʼe	 k u i m b a ʼ e |
katupyry	 k a t u p y r y |
ombaʼapóva	 o m b a ʼ a p ó v a |
ikokuépe	 i k o k u é p e |
araka'eve	 a r a k a ' e v e |
jeko	 j e k o |
ndojehúi	 n d o j e h ú i |
itajyramíme	 i t a j y r a m í m e |
mba'eve	 m b a ' e v e |
ivaíva	 i v a í v a |
tapicha	 t a p i c h a |
hetãrayhúva	 h e t ã r a y h ú v a |
ho'a	 h o ' a |
ñuhã	 ñ u h ã |
guasúpe	 g u a s ú p e |
avy'aitépa	 a v y ' a i t é p a |
upéicharõ	 u p é i c h a r õ |
guarani	 g u a r a n i |
ñe'ẽténte	 ñ e ' ẽ t é n t e |
ojepuru	 o j e p u r u |
anatápente	 a n a t á p e n t e |
ojekuaavéva	 o j e k u a a v é v a |
mba'érepiko	 m b a ' é r e p i k o |
reñemomombyryete	 r e ñ e m o m o m b y r y e t e |
orehegui	 o r e h e g u i |
mbaʼe	 m b a ʼ e |
ohesy	 o h e s y |
tatápe	 t a t á p e |
ma'erãpiko	 m a ' e r ã p i k o |
ñañemoakãrasýta	 ñ a ñ e m o a k ã r a s ý t a |
vy'apópe	 v y ' a p ó p e |
oikókuri	 o i k ó k u r i |
oñondive	 o ñ o n d i v e |
opavave	 o p a v a v e |
ijaty	 i j a t y |
tupãópe	 t u p ã ó p e |
omongaraívo	 o m o n g a r a í v o |
pindo	 p i n d o |
ojejapóva	 o j e j a p ó v a |
ogapýpe	 o g a p ý p e |
chéveramo	 c h é v e r a m o |
g̃uarã	 g ̃ u a r ã |
ahechahague	 a h e c h a h a g u e |
jaguarete	 j a g u a r e t e |
og̃uahẽvo	 o g ̃ u a h ẽ v o |
mbokaja	 m b o k a j a |
tuja	 t u j a |
renondépe	 r e n o n d é p e |
upéicha	 u p é i c h a |
che	 c h e |
irũnguéra	 i r ũ n g u é r a |
avei	 a v e i |
oisãmbyhy	 o i s ã m b y h y |
kuatiahaipyre	 k u a t i a h a i p y r e |
itavapegua	 i t a v a p e g u a |
néi,	 n é i , |
aháta	 a h á t a |
nendive	 n e n d i v e |
oikojeýkuri	 o i k o j e ý k u r i |
pyhare	 p y h a r e |
ndaikatuvéima	 n d a i k a t u v é i m a |
ojejapo	 o j e j a p o |
hese	 h e s e |
mbaʼeve	 m b a ʼ e v e |
onohẽmbaitékuri	 o n o h ẽ m b a i t é k u r i |
karai	 k a r a i |
kurusu	 k u r u s u |
ojuhúva	 o j u h ú v a |
hapépe	 h a p é p e |
oikóva	 o i k ó v a |
ambue	 a m b u e |
táva	 t á v a |
rupi	 r u p i |
ajetepyso	 a j e t e p y s o |
asẽ	 a s ẽ |
korapýpe	 k o r a p ý p e |
mborayhu	 m b o r a y h u |
ijapyra'ỹva	 i j a p y r a ' ỹ v a |
iñirũnguéra	 i ñ i r ũ n g u é r a |
ohupi	 o h u p i |
ijyva	 i j y v a |
ári	 á r i |
mávapa	 m á v a p a |
mboʼehára	 m b o ʼ e h á r a |
ikatupyryvéva?	 i k a t u p y r y v é v a ? |
mba'eichahápepiko	 m b a ' e i c h a h á p e p i k o |
nderehe	 n d e r e h e |
upéva	 u p é v a |
heko	 h e k o |
mano	 m a n o |
Teʼõnguekuaaty	 T e ʼ õ n g u e k u a a t y |
Ayvureko	 A y v u r e k o |
rehe	 r e h e |
ary	 a r y |
Pyahúpe	 P y a h ú p e |
ndahaʼéi	 n d a h a ʼ é i |
imbaipýva	 i m b a i p ý v a |
ita'yrakuéra	 i t a ' y r a k u é r a |
oipytyvõkuri	 o i p y t y v õ k u r i |
ichupe	 i c h u p e |
ajépango	 a j é p a n g o |
ijetu'u	 i j e t u ' u |
hoga'ỹva	 h o g a ' ỹ v a |
rekove	 r e k o v e |
oúkuri	 o ú k u r i |
hendápe	 h e n d á p e |
ojerurévo	 o j e r u r é v o |
pytyvõ,	 p y t y v õ , |
tembi'u	 t e m b i ' u |
térã	 t é r ã |
pirapire	 p i r a p i r e |
ahekahína	 a h e k a h í n a |
hermanope	 h e r m a n o p e |
upe	 u p e |
aravópe	 a r a v ó p e |
oñe'ẽ	 o ñ e ' ẽ |
mitãmimícha	 m i t ã m i m í c h a |
heta	 h e t a |
hembiapokue	 h e m b i a p o k u e |
oñembohasa	 o ñ e m b o h a s a |
taʼãngaryrýipe	 t a ʼ ã n g a r y r ý i p e |
ára	 á r a |
ára,	 á r a , |
pyharevete	 p y h a r e v e t e |
oguerahava'erã	 o g u e r a h a v a ' e r ã |
vaka	 v a k a |
kamby	 k a m b y |
távape	 t á v a p e |
araka'épa	 a r a k a ' é p a |
rejevýta	 r e j e v ý t a |
ojehu	 o j e h u |
rire	 r i r e |
katu	 k a t u |
atererehína	 a t e r e r e h í n a |
kavaju	 k a v a j u |
ovéro	 o v é r o |
ikatupyry	 i k a t u p y r y |
imbaretéva	 i m b a r e t é v a |
ág̃akatu	 á g ̃ a k a t u |
Maria	 M a r i a |
noñemeʼẽi	 n o ñ e m e ʼ ẽ i |
mavavépe	 m a v a v é p e |
tenda	 t e n d a |
ijyvy	 i j y v y |
he'õva	 h e ' õ v a |
noñembo'éi	 n o ñ e m b o ' é i |
peẽme	 p e ẽ m e |
mba'épa	 m b a ' é p a |
pejapova'erã	 p e j a p o v a ' e r ã |
ág̃a	 á g ̃ a |
oikóramo	 o i k ó r a m o |
umíva	 u m í v a |
ndaikatuivoíkuri	 n d a i k a t u i v o í k u r i |
oke	 o k e |
ndépa	 n d é p a |
reikuaa	 r e i k u a a |
moõpa	 m o õ p a |
Iglesia	 I g l e s i a |
de	 d e |
la	 l a |
Encarnación	 E n c a r n a c i ó n |
hapicha	 h a p i c h a |
ohayhu'ỹva	 o h a y h u ' ỹ v a |
py'ỹinte	 p y ' ỹ i n t e |
Luchi	 L u c h i |
ojojuhúmiva'erã	 o j o j u h ú m i v a ' e r ã |
oñomongeta	 o ñ o m o n g e t a |
kyre'ỹ	 k y r e ' ỹ |
py'aevoi	 p y ' a e v o i |
hogayguakuéra	 h o g a y g u a k u é r a |
ogueru	 o g u e r u |
ikahõrã	 i k a h õ r ã |
jepiveguáicha	 j e p i v e g u á i c h a |
oñembosako'i	 o ñ e m b o s a k o ' i |
mokõive	 m o k õ i v e |
osẽ	 o s ẽ |
hag̃ua	 h a g ̃ u a |
oñembo'e	 o ñ e m b o ' e |
upéi	 u p é i |
ohypýi	 o h y p ý i |
ykaraipyrépe	 y k a r a i p y r é p e |
tanepytyvõna	 t a n e p y t y v õ n a |
jaha	 j a h a |
jaterere	 j a t e r e r e |
upépe	 u p é p e |
omba'apo	 o m b a ' a p o |
koʼág̃a	 k o ʼ á g ̃ a |
oĩháicha	 o ĩ h á i c h a |
ndikatúi	 n d i k a t ú i |
marta	 m a r t a |
omohenda	 o m o h e n d a |
hi'upy	 h i ' u p y |
mesápe	 m e s á p e |
ohendu	 o h e n d u |
ojepopetéva	 o j e p o p e t é v a |
mba'asy	 m b a ' a s y |
oikesapy'árõ	 o i k e s a p y ' á r õ |
nde	 n d e |
retépe	 r e t é p e |
oñeñanduka	 o ñ e ñ a n d u k a |
heñoi'akue	 h e ñ o i ' a k u e |
Itauguápe	 I t a u g u á p e |
y	 y |
tapemimíre	 t a p e m i m í r e |
osyry	 o s y r y |
mba'etekópio	 m b a ' e t e k ó p i o |
aha'ãrõ	 a h a ' ã r õ |
ne	 n e |
mbohovái	 m b o h o v á i |
vove	 v o v e |
yvate	 y v a t e |
gotyo	 g o t y o |
ahava'erã	 a h a v a ' e r ã |
neipamírõ	 n e i p a m í r õ |
ohendujeyjeýkuri	 o h e n d u j e y j e ý k u r i |
máva	 m á v a |
ombotáva	 o m b o t á v a |
tereréniko	 t e r e r é n i k o |
angirũ	 a n g i r ũ |
ñanderayhurakate'ỹva	 ñ a n d e r a y h u r a k a t e ' ỹ v a |
heseʼỹ	 h e s e ʼ ỹ |
iñapysẽ	 i ñ a p y s ẽ |
hembiapovusu	 h e m b i a p o v u s u |
malvina	 m a l v i n a |
Ñorairõ	 Ñ o r a i r õ |
iñakãnundu	 i ñ a k ã n u n d u |
hy'ái	 h y ' á i |
ososopa	 o s o s o p a |
aníke	 a n í k e |
ndepojopy	 n d e p o j o p y |
tomboyke	 t o m b o y k e |
pokarẽ,	 p o k a r ẽ , |
tovamokõi,	 t o v a m o k õ i , |
ñembotavy	 ñ e m b o t a v y |
oparei	 o p a r e i |
oĩ	 o ĩ |
pohãnohára	 p o h ã n o h á r a |
ndoipurúiva	 n d o i p u r ú i v a |
ñana	 ñ a n a |
pya'épiko	 p y a ' é p i k o |
reju	 r e j u |
jeýta	 j e ý t a |
japracticáma	 j a p r a c t i c á m a |
oñeñongatu	 o ñ e ñ o n g a t u |
oikonte'arãvoi	 o i k o n t e ' a r ã v o i |
opavavéva	 o p a v a v é v a |
omombaʼeguasúkuri	 o m o m b a ʼ e g u a s ú k u r i |
ojejapómava	 o j e j a p ó m a v a |
chemoirũke	 c h e m o i r ũ k e |
irũ	 i r ũ |
jaikuaa	 j a i k u a a |
jasypápe	 j a s y p á p e |
ojehasa'asyha	 o j e h a s a ' a s y h a |
oparupiete	 o p a r u p i e t e |
oikova'erã	 o i k o v a ' e r ã |
chehegui	 c h e h e g u i |
oñemondasapy'árõ	 o ñ e m o n d a s a p y ' á r õ |
ejohéi	 e j o h é i |
guampa	 g u a m p a |
iky'áva	 i k y ' á v a |
porã	 p o r ã |
omba'apokuaágui	 o m b a ' a p o k u a á g u i |
oñemoña	 o ñ e m o ñ a |
hupi'águi	 h u p i ' á g u i |
oguapyjeko	 o g u a p y j e k o |
yvyráre	 y v y r á r e |
kuarahy'ãme	 k u a r a h y ' ã m e |
oguereko	 o g u e r e k o |
po	 p o |
mitã	 m i t ã |
mbovy	 m b o v y |
arýpa	 a r ý p a |
reguereko	 r e g u e r e k o |
ikyre'ỹetéva	 i k y r e ' ỹ e t é v a |
voi	 v o i |
opu'ã	 o p u ' ã |
chekaigue,	 c h e k a i g u e , |
ra'a	 r a ' a |
ombopupuva'erã	 o m b o p u p u v a ' e r ã |
hykuere	 h y k u e r e |
hoy'uva'erã	 h o y ' u v a ' e r ã |
ama	 a m a |
totyky	 t o t y k y |
mbeguemi	 m b e g u e m i |
omboperepepe,	 o m b o p e r e p e p e , |
omosunu	 o m o s u n u |
omboparapa	 o m b o p a r a p a |
sombrero	 s o m b r e r o |
ka'a	 k a ' a |
péicha	 p é i c h a |
jave	 j a v e |
ropu'ãmiva'erã	 r o p u ' ã m i v a ' e r ã |
rohechávo	 r o h e c h á v o |
mymbáre	 m y m b á r e |
ñeñangareko	 ñ e ñ a n g a r e k o |
ohayhu	 o h a y h u |
añete	 a ñ e t e |
Hilario	 H i l a r i o |
hogayguakuérape	 h o g a y g u a k u é r a p e |
cheñyrõmi	 c h e ñ y r õ m i |
ikatúpa	 i k a t ú p a |
ahasami	 a h a s a m i |
jekoraka'e	 j e k o r a k a ' e |
giménez	 g i m é n e z |
itarovavéntema	 i t a r o v a v é n t e m a |
uperire	 u p e r i r e |
mba'eichajoaitépa	 m b a ' e i c h a j o a i t é p a |
chemandu'a	 c h e m a n d u ' a |
jey	 j e y |
ag̃uahẽva'ekue	 a g ̃ u a h ẽ v a ' e k u e |
hi'ariete	 h i ' a r i e t e |
ndéngo	 n d é n g o |
kuimba'e	 k u i m b a ' e |
nderekomarãva	 n d e r e k o m a r ã v a |
opóvoi	 o p ó v o i |
heʼi	 h e ʼ i |
Gonzálezpe	 G o n z á l e z p e |
“Rehendúparaʼe”	 “ R e h e n d ú p a r a ʼ e ” |
vare'aitereíkuri	 v a r e ' a i t e r e í k u r i |
oñemongeta	 o ñ e m o n g e t a |
hendive	 h e n d i v e |
akóinte	 a k ó i n t e |
iñorairõme	 i ñ o r a i r õ m e |
oipurúkuri	 o i p u r ú k u r i |
pyʼaguapy	 p y ʼ a g u a p y |
reko	 r e k o |
ojapouka	 o j a p o u k a |
ohayhúgui	 o h a y h ú g u i |
rembiayhujárape	 r e m b i a y h u j á r a p e |
omohu'ãkuri	 o m o h u ' ã k u r i |
mbo'esyry	 m b o ' e s y r y |
mbohapyha	 m b o h a p y h a |
hetave	 h e t a v e |
ouhína	 o u h í n a |
hembiaporã	 h e m b i a p o r ã |
Avañeʼẽre	 A v a ñ e ʼ ẽ r e |
tereiko	 t e r e i k o |
tekokatúpe	 t e k o k a t ú p e |
oñapytĩ	 o ñ a p y t ĩ |
ikyha	 i k y h a |
tatakua	 t a t a k u a |
kótare	 k ó t a r e |
okaru	 o k a r u |
ombojoapy	 o m b o j o a p y |
ju'i	 j u ' i |
opurahéi	 o p u r a h é i |
jave,	 j a v e , |
okýta	 o k ý t a |
upémarõ	 u p é m a r õ |
he'i	 h e ' i |
añetehápe,	 a ñ e t e h á p e , |
iñirũmimi	 i ñ i r ũ m i m i |
oñembohorýmiva'erã	 o ñ e m b o h o r ý m i v a ' e r ã |
heterasypaitésapy'a	 h e t e r a s y p a i t é s a p y ' a |
tupã	 t u p ã |
tanehaʼãrõ	 t a n e h a ʼ ã r õ |
roʼy	 r o ʼ y |
hi'a	 h i ' a |
omongaru	 o m o n g a r u |
opavavetépe	 o p a v a v e t é p e |
ome'ẽ	 o m e ' ẽ |
kurundu'imi	 k u r u n d u ' i m i |
maymaite	 m a y m a i t e |
ovyʼákuri	 o v y ʼ á k u r i |
ipirapirehetáva	 i p i r a p i r e h e t á v a |
imboriahúva	 i m b o r i a h ú v a |
ndopái	 n d o p á i |
nomohu'ãi	 n o m o h u ' ã i |
iñemoarandu	 i ñ e m o a r a n d u |
ndaipóringo	 n d a i p ó r i n g o |
ndehegui	 n d e h e g u i |
herakuãporãvéva	 h e r a k u ã p o r ã v é v a |
ñemuháme	 ñ e m u h á m e |
jahána	 j a h á n a |
reipepirũ	 r e i p e p i r ũ |
iñirũme	 i ñ i r ũ m e |
haʼekuéra	 h a ʼ e k u é r a |
villarrica	 v i l l a r r i c a |
ararecha	 a r a r e c h a |
dengue	 d e n g u e |
ndejapyhýrõ	 n d e j a p y h ý r õ |
pya'emíke	 p y a ' e m í k e |
tereho	 t e r e h o |
rendápe	 r e n d á p e |
eñangarekomi	 e ñ a n g a r e k o m i |
cherehe	 c h e r e h e |
pokatu	 p o k a t u |
tuichaitévape	 t u i c h a i t é v a p e |
maria	 m a r i a |
ohómiva'erá	 o h ó m i v a ' e r á |
oñemombo	 o ñ e m o m b o |
hupápe	 h u p á p e |
hasẽ	 h a s ẽ |
soro	 s o r o |
chipa	 c h i p a |
manduvi	 m a n d u v i |
eho	 e h o |
eñami	 e ñ a m i |
guyra	 g u y r a |
opaichagua	 o p a i c h a g u a |
chénte	 c h é n t e |
ha'e	 h a ' e |
ndavy'amo'ãitaha	 n d a v y ' a m o ' ã i t a h a |
so'o'ỹre	 s o ' o ' ỹ r e |
are	 a r e |
mba'éiko	 m b a ' é i k o |
ajapokuaa	 a j a p o k u a a |
eikove	 e i k o v e |
eheja	 e h e j a |
ambuépe	 a m b u é p e |
toikove	 t o i k o v e |
emboscada	 e m b o s c a d a |
araitépe	 a r a i t é p e |
jepérõ	 j e p é r õ |
mba'evéma	 m b a ' e v é m a |
ndaikatúi	 n d a i k a t ú i |
ojapovévo	 o j a p o v é v o |
leõ	 l e õ |
oike	 o i k e |
eñomongetami	 e ñ o m o n g e t a m i |
remimbo'e	 r e m i m b o ' e |
ndive	 n d i v e |
norohenduvéi	 n o r o h e n d u v é i |
ae	 a e |
yvy	 y v y |
oñepyrũjeytaha	 o ñ e p y r ũ j e y t a h a |
temitỹ	 t e m i t ỹ |
ojerurékuri	 o j e r u r é k u r i |
oñeguenohẽ	 o ñ e g u e n o h ẽ |
ita	 i t a |
ombotýva	 o m b o t ý v a |
jeikeha	 j e i k e h a |
clari	 c l a r i |
róga	 r ó g a |
hekove	 h e k o v e |
ru'ã	 r u ' ã |
sapy'aite	 s a p y ' a i t e |
ipirueterei	 i p i r u e t e r e i |
oñemeʼẽkuri	 o ñ e m e ʼ ẽ k u r i |
jasy	 j a s y |
ohasa	 o h a s a |
ápe	 á p e |
aime	 a i m e |
roipytyvõ	 r o i p y t y v õ |
héra	 h é r a |
ryke'y	 r y k e ' y |
araka'épiko	 a r a k a ' é p i k o |
oñemoarandúta	 o ñ e m o a r a n d ú t a |
ahupytypotáma	 a h u p y t y p o t á m a |
michĩ	 m i c h ĩ |
ha'úkuri	 h a ' ú k u r i |
hu'y	 h u ' y |
apýre	 a p ý r e |
omoĩ	 o m o ĩ |
raguemimi	 r a g u e m i m i |
oñepyrũkuri	 o ñ e p y r ũ k u r i |
puraheikuaápe	 p u r a h e i k u a á p e |
yva	 y v a |
he'ẽ	 h e ' ẽ |
vokóike	 v o k ó i k e |
g̃uaig̃uimi	 g ̃ u a i g ̃ u i m i |
ohechaukákuri	 o h e c h a u k á k u r i |
ta'ãnga	 t a ' ã n g a |
roñe'ẽmbareihína	 r o ñ e ' ẽ m b a r e i h í n a |
rogayguakuéra	 r o g a y g u a k u é r a |
ejerure	 e j e r u r e |
toñemoĩ	 t o ñ e m o ĩ |
purahéi	 p u r a h é i |
pyhare,	 p y h a r e , |
ho'ysã,	 h o ' y s ã , |
ro'yeterei	 r o ' y e t e r e i |
kuruvaíre	 k u r u v a í r e |
ñañe'ẽñaína	 ñ a ñ e ' ẽ ñ a í n a |
sapy'apy'a	 s a p y ' a p y ' a |
ojejuhu	 o j e j u h u |
Pláta	 P l á t a |
Yvyguy	 Y v y g u y |
ani	 a n i |
rekaguai	 r e k a g u a i |
ndejehe	 n d e j e h e |
upévare	 u p é v a r e |
ndaipóri	 n d a i p ó r i |
ojesareko'ỹva	 o j e s a r e k o ' ỹ v a |
ka'arupytũ	 k a ' a r u p y t ũ |
og̃uahẽ	 o g ̃ u a h ẽ |
árape	 á r a p e |
ojehova'erã	 o j e h o v a ' e r ã |
paíno	 p a í n o |
maína	 m a í n a |
rógape	 r ó g a p e |
ikane'õmarõ	 i k a n e ' õ m a r õ |
oheka	 o h e k a |
ogami	 o g a m i |
opytu'u	 o p y t u ' u |
osẽkuri	 o s ẽ k u r i |
ohopa	 o h o p a |
heseve	 h e s e v e |
Brasil-pe	 B r a s i l - p e |
ỹramo	 ỹ r a m o |
eme'ẽkuaa	 e m e ' ẽ k u a a |
chéve	 c h é v e |
tembi'urã	 t e m b i ' u r ã |
aiko	 a i k o |
pya'épeko	 p y a ' é p e k o |
oho	 o h o |
ipiári	 i p i á r i |
kavure	 k a v u r e |
avy'aite	 a v y ' a i t e |
rohecháre	 r o h e c h á r e |
ha’e	 h a ’ e |
ituicha	 i t u i c h a |
sa'ivépe	 s a ' i v é p e |
jajoavy	 j a j o a v y |
ñaña	 ñ a ñ a |
ha'eño	 h a ' e ñ o |
roikévo	 r o i k é v o |
ka'aguy'ípe	 k a ' a g u y ' í p e |
ajovasa	 a j o v a s a |
rejapóta	 r e j a p ó t a |
rejaposéva	 r e j a p o s é v a |
reguerekóta	 r e g u e r e k ó t a |
reipotáva	 r e i p o t á v a |
oporandu	 o p o r a n d u |
mitã'ikúerape	 m i t ã ' i k ú e r a p e |
osẽva	 o s ẽ v a |
haku	 h a k u |
jepémo	 j e p é m o |
ñomongeta	 ñ o m o n g e t a |
ko'ã	 k o ' ã |
mba'ére,	 m b a ' é r e , |
noñeg̃uahẽi	 n o ñ e g ̃ u a h ẽ i |
ñe'ẽme	 ñ e ' ẽ m e |
hogue	 h o g u e |
hovykangy	 h o v y k a n g y |
reikuaa'ỹre	 r e i k u a a ' ỹ r e |
ojehepyme'ẽta	 o j e h e p y m e ' ẽ t a |
namyengoviái	 n a m y e n g o v i á i |
tesapeha	 t e s a p e h a |
upémaramo	 u p é m a r a m o |
ña	 ñ a |
omoneijeýkuri	 o m o n e i j e ý k u r i |
mbaʼéichapa	 m b a ʼ é i c h a p a |
sy	 s y |
maymave	 m a y m a v e |
ohenói	 o h e n ó i |
Uruku	 U r u k u |
ohecha	 o h e c h a |
Lovi	 L o v i |
omanoite	 o m a n o i t e |
vera	 v e r a |
ha'eñoiténiko	 h a ' e ñ o i t é n i k o |
omongakuaákuri	 o m o n g a k u a á k u r i |
chupekuéra	 c h u p e k u é r a |
rejapokuaa	 r e j a p o k u a a |
ohorãngue	 o h o r ã n g u e |
Tasyópe	 T a s y ó p e |
Kapiatã	 K a p i a t ã |
ruguápe	 r u g u á p e |
oñesũvaʼekue	 o ñ e s ũ v a ʼ e k u e |
ojojuhu	 o j o j u h u |
mitã'i	 m i t ã ' i |
Peru'i	 P e r u ' i |
yvakuéra	 y v a k u é r a |
ijupe	 i j u p e |
ohechávo	 o h e c h á v o |
guasuete	 g u a s u e t e |
kapi'ipe	 k a p i ' i p e |
jeporu	 j e p o r u |
ipirapire	 i p i r a p i r e |
kakuaa	 k a k u a a |
aranduete	 a r a n d u e t e |
mba'ejegua	 m b a ' e j e g u a |
apohára	 a p o h á r a |
ijojaha'ỹva	 i j o j a h a ' ỹ v a |
oipytyvõ	 o i p y t y v õ |
pytuhẽ	 p y t u h ẽ |
ra'ýpiko	 r a ' ý p i k o |
noĩporãmbáimba'e	 n o ĩ p o r ã m b á i m b a ' e |
Perurima	 P e r u r i m a |
apysápe	 a p y s á p e |
marandu	 m a r a n d u |
pyahu	 p y a h u |
urdu	 u r d u |
ñe'ẽ	 ñ e ' ẽ |
haimete	 h a i m e t e |
amandajépe	 a m a n d a j é p e |
ohechakuaa	 o h e c h a k u a a |
oñembohoryseha	 o ñ e m b o h o r y s e h a |
asaje	 a s a j e |
pukukue	 p u k u k u e |
javeve	 j a v e v e |
Karai	 K a r a i |
Octubre	 O c t u b r e |
oikundaha	 o i k u n d a h a |
omopotĩsékuri	 o m o p o t ĩ s é k u r i |
kuehe	 k u e h e |
rekyhyje	 r e k y h y j e |
chugui	 c h u g u i |
akeséma	 a k e s é m a |
jajoecha	 j a j o e c h a |
peve	 p e v e |
ndahamo'ãi	 n d a h a m o ' ã i |
ndorojukamo'ãi	 n d o r o j u k a m o ' ã i |
upéikatu	 u p é i k a t u |
oñe'ẽkuri	 o ñ e ' ẽ k u r i |
mbo'ehára	 m b o ' e h á r a |
emaña	 e m a ñ a |
embohysýi	 e m b o h y s ý i |
nemombaretéva	 n e m o m b a r e t é v a |
añetehápe	 a ñ e t e h á p e |
kóva	 k ó v a |
membykuña	 m e m b y k u ñ a |
hakate'ỹjekoraka'e	 h a k a t e ' ỹ j e k o r a k a ' e |
Chopombe	 C h o p o m b e |
ojerejey	 o j e r e j e y |
karia'y	 k a r i a ' y |
mavavéva	 m a v a v é v a |
noipohãnokuaái	 n o i p o h ã n o k u a á i |
ñasaindy	 ñ a s a i n d y |
porãme	 p o r ã m e |
Ulo	 U l o |
oguapyhína	 o g u a p y h í n a |
itapỹi	 i t a p ỹ i |
ndaikatumo'ãvéima	 n d a i k a t u m o ' ã v é i m a |
remyatyrõ	 r e m y a t y r õ |
Carmen	 C a r m e n |
hasykatuetévoi	 h a s y k a t u e t é v o i |
ho'ysã	 h o ' y s ã |
oky	 o k y |
oréniko	 o r é n i k o |
noromomba'eguasúi	 n o r o m o m b a ' e g u a s ú i |
ñepyrũrãme	 ñ e p y r ũ r ã m e |
oñembyatypaite	 o ñ e m b y a t y p a i t e |
teroja	 t e r o j a |
tekome'ẽva	 t e k o m e ' ẽ v a |
puru	 p u r u |
hendiverã	 h e n d i v e r ã |
ka'ay	 k a ' a y |
Alfonso	 A l f o n s o |
itajýra	 i t a j ý r a |
ova	 o v a |
rajymi	 r a j y m i |
hasykatuetéva	 h a s y k a t u e t é v a |
oguerokirĩnte	 o g u e r o k i r ĩ n t e |
avati,	 a v a t i , |
mandi'o,	 m a n d i ' o , |
ambuéva	 a m b u é v a |
iglesia	 i g l e s i a |
Parroquial	 P a r r o q u i a l |
Yvyjaʼu	 Y v y j a ʼ u |
hendy'imi	 h e n d y ' i m i |
tata	 t a t a |
ogue	 o g u e |
iñe'ẽporãhaipyre	 i ñ e ' ẽ p o r ã h a i p y r e |
rekotee	 r e k o t e e |
vaicháku	 v a i c h á k u |
oñoha'ãva	 o ñ o h a ' ã v a |
ogaygua	 o g a y g u a |
ikorapymíme	 i k o r a p y m í m e |
oñandu	 o ñ a n d u |
pytu	 p y t u |
kuimba'e'i	 k u i m b a ' e ' i |
karape,	 k a r a p e , |
haguepáva,	 h a g u e p á v a , |
ojoguáva	 o j o g u á v a |
karaja'ípe	 k a r a j a ' í p e |
oĩva	 o ĩ v a |
ka'irãime	 k a ' i r ã i m e |
asia	 a s i a |
ñe'ẽnguéra	 ñ e ' ẽ n g u é r a |
ehasa	 e h a s a |
jakay'u	 j a k a y ' u |
ta'eporãmivoi	 t a ' e p o r ã m i v o i |
léi	 l é i |
ojepurúta	 o j e p u r ú t a |
ñemoarandu	 ñ e m o a r a n d u |
ñemosãsorã	 ñ e m o s ã s o r ã |
omymbajukaitereíva	 o m y m b a j u k a i t e r e í v a |
oréve	 o r é v e |
pohã	 p o h ã |
oréko	 o r é k o |
oreresãi	 o r e r e s ã i |
rovy'a	 r o v y ' a |
amo	 a m o |
roimehápe	 r o i m e h á p e |
roñomongeta	 r o ñ o m o n g e t a |
pya'evoi	 p y a ' e v o i |
rog̃uahẽ	 r o g ̃ u a h ẽ |
peteĩva	 p e t e ĩ v a |
pende	 p e n d e |
apytégui	 a p y t é g u i |
cheme'ẽta	 c h e m e ' ẽ t a |
ndarekói	 n d a r e k ó i |
aha	 a h a |
hag̃uáicha	 h a g ̃ u á i c h a |
mymbakuéra	 m y m b a k u é r a |
upepeguápe,	 u p e p e g u á p e , |
ka'i,	 k a ' i , |
ko'ág̃a	 k o ' á g ̃ a |
ojehecharamo	 o j e h e c h a r a m o |
oñemomorã	 o ñ e m o m o r ã |
mba'épiko	 m b a ' é p i k o |
ja'éta	 j a ' é t a |
iporãrasa	 i p o r ã r a s a |
opa	 o p a |
rehegua	 r e h e g u a |
papo	 p a p o |
omañasapyʼami	 o m a ñ a s a p y ʼ a m i |
orerehe	 o r e r e h e |
hykuepángo	 h y k u e p á n g o |
oĩmíva	 o ĩ m í v a |
pemboy'u	 p e m b o y ' u |
pembohasa	 p e m b o h a s a |
akãrasy	 a k ã r a s y |
amomba'eguasúniko	 a m o m b a ' e g u a s ú n i k o |
ikatúre	 i k a t ú r e |
ahasa	 a h a s a |
arave	 a r a v e |
ahayhúva	 a h a y h ú v a |
ogueraháma	 o g u e r a h á m a |
eporohetũ	 e p o r o h e t ũ |
noñanduivavoi	 n o ñ a n d u i v a v o i |
kane'õ	 k a n e ' õ |
ka'asapa	 k a ' a s a p a |
sapy'aitépe	 s a p y ' a i t é p e |
ogueropojáima	 o g u e r o p o j á i m a |
imba'ejerure	 i m b a ' e j e r u r e |
